Cell	ImmClassifier_prediction
ACTCTCGTCAGCGTCG	L:T:CD8:EMRA
AGCGTCGCACAGCCAC	L:NK
TCGTGGGGTTTCCAAG	L:T:CD4:CM
ATCGTGAAGTCGAATA	L:T:CD4:CM
CAGAGCCTCGCTCCTA	L:T:CD8:EM
CGAGTGCGTCGTTGCG	L:B:PC
GTCGTAACATGTCGTA	L:T:CD8:EMRA
TCGTGGGAGAATCGCG	L:T:CD8:EMRA
TCGTGGGGTGCTCGTG	L:T:CD4:EM
AATCGTGCAGACCTGC	L:T:CD4:CM
AGCGTCGGTACTGTTG	L:T:CD8:EMRA
CGTGTCTCAACTCCAA	L:T:CD4:Tfh
TTCACGCGTCGTTATG	L:T:CD4:CM
AGCGTCGCAATACGAA	L:T:CD8:EM
CCGGGTAGTAGATGTA	L:T:CD4:CM
TACGTCCAGCGTCGAA	L:T:CD4:CM
TCCATGCGTCGTTCAA	L:T:CD8:EMRA
TCCTGCAGTGATATAG	L:T:CD4:CM
TCGTGGGTCAGGGATG	L:NK
AGCGTATGTGTAGGAC	L:NK
CTCCAACGTCACTACA	L:T:CD8:EMRA
GAGACTTTCGCGTCGA	L:T:CD4:Naive
GGGTCACGTCGTGGAA	L:T:CD4:CM
GGGTGTCGTGTACAGG	L:T:CD4:Naive
GTCATTTTCGCGTCGA	L:T:CD4:Naive
TCGGGTGGTGGACTGA	L:T:CD8:EMRA
AGCCAATGTGCGTCGT	L:T:CD4:CM
ACCGTTCGTCGTGCCA	L:B:PC
GTCATGAAGGCCACTC	L:T:CD4:CM
TCATACTTCTCCAAGA	L:T:CD8:EMRA
TCCGTGTCACACAGAG	L:T:CD4:CM
TCGCTTGTCGGAAACG	L:T:CD4:CM
TCGTCCAGTAGTACGG	L:T:CD4:Naive
CAAGCTAGTTTACGAC	L:T:CD4:CM
CATCGTCGTCTGTGTA	L:B:PC
CGTGTCTGTGGCGCTT	L:NK
GTCGTTCGTTAGCGGA	L:T:CD4:CM
GTGCTTCGTGTTCAGT	L:T:CD8:EMRA
TCGCACTGTACGCGTC	L:NK
TTACGCCGTGTTGATC	L:T:CD4:Naive
ACGATGTTCAGCGTCG	L:T:CD8:EMRA
CTGTGAAGTCGTGGTC	L:T:CD8:CM
GCCGTGACATTCGATG	L:T:CD4:CM
GTCATTTTCGATGCAT	L:T:CD4:EM
GTCGCGACACCCTGAG	L:NK
GTCGTTCTCGTTCATT	L:T:CD4:Naive
TAAGCCAAGTTAGTGA	L:T:CD4:CM
TCATGGAGTGGCTTGC	L:T:CD8:EMRA
TCCGTGTGTCAGTCGC	L:T:CD4:Naive
TCGCACTTCCGCCTAT	L:T:CD4:CM
TCGTAGAAGTACCATC	L:T:CD4:Naive
TCGTGGGTCTATCGTT	L:T:CD4:Naive
TTTCATGTCCTATGGA	L:T:CD4:EM
ATTGGGTAGGTACCTT	L:T:CD8:EMRA
CACAGGCGTCGTTGGC	L:T:CD4:Naive
CGTGCTTAGTCAGGGT	L:B:PC
CGTGTCTCAGTTGTCA	L:T:CD4:CM
GCCCAGAAGTGCGTCC	L:T:CD4:CM
GGAGGTAAGAGCATCG	L:T:CD4:CM
GGCGTCAAGGCACTAG	L:T:CD4:CM
TCGGGTGGTTTGGAAA	L:T:CD4:CM
TTTCAGTTCAGCGTCG	L:NK
AGAAGCGTCTCTGCTG	L:T:CD4:CM
ATTGTTCTCGTTCGCT	L:T:CD4:Naive
CACGAATAGGCTGGAT	L:NK
CAGTGCGTCCAGTGTA	L:T:CD4:EM
CATCGGGAGCGCCTTG	L:NK
CTAACCCAGGGAGGAC	L:T:CD4:Naive
CTACAGAAGACGTCGA	L:T:CD4:CM
CTGAGGCGTCGAGATG	L:T:CD4:Naive
GCGTGCACAAGTGTCT	L:T:CD4:Naive
GTCGCGATCTGCACCT	L:T:CD4:Naive
GTCGTAAGTATCAAGA	L:T:CD4:Naive
TCGGATAGTGAGCTCC	L:T:CD4:CM
TCGTAGAAGCTGAAAT	L:T:CD4:Naive
AAGCGTTTCGTGGACC	L:T:CD4:Naive
CGACAGCGTCAAGGCA	L:T:CD4:EM
CGTGCTTAGGGCATGT	CD34
CGTGTCTAGGTTGCCC	L:NK
CTATCCGTCGCGTGCA	L:T:CD4:CM
CTGATCCCATGGCACC	L:T:CD4:Naive
GTCGAATAGTGAGGTC	L:T:CD4:CM
GTCGAATGTCAGCGTC	L:T:CD4:CM
TAGAGTCGTCGATGCC	L:T:CD8:EMRA
TCACTATGTTCTTCAT	L:T:CD4:EM
TCCTCGAGTAGGTGCA	L:T:CD8:EMRA
TCGACGGCATGATGCT	L:T:CD8:Naive
TCGTCCAGTGACGTCC	L:B:PC
TGCTGAAAGGCTTAGG	L:B:PC
TGTCCTGCAGGCTTGC	L:T:CD4:CM
TTGCGTCCAGGCCCTA	L:T:CD4:Naive
AATCGACAGTTGCGCC	L:T:CD8:EM
ATGCGATGTTGGTAGG	L:T:CD4:CM
ATTCAGGGTGACTCTA	L:T:CD8:EMRA
ATTCCATAGCGTCTCG	L:T:CD4:CM
CAGTGCGTCATTCGGA	L:T:CD4:Naive
CCGTGAGCACAAGTGG	L:T:CD4:Naive
CGTAATGAGCCGGATA	L:T:CD8:EM
CGTGCTTGTCAGCGTC	L:T:CD4:Naive
CTGTCGTGTTCTCTCG	L:B:PC
GTCGTAAAGGCCCACT	L:NK
GTCGTAATCCTGCTAC	L:T:CD8:EMRA
TCGGGACAGCACTCCG	L:T:CD4:Naive
TCGTAGATCATCTACT	L:T:CD4:Naive
TGTAGACGTCGCAGTC	L:T:CD4:CM
AGCGCCAGTGCCAAGA	L:T:CD4:Naive
AGGACTTCAGACGCTC	L:T:CD8:EMRA
CCGTGAGTCCACAGCG	L:T:CD4:Naive
CGAATTGTCTGTTGGA	L:T:CD4:CM
CGCGTGATCGCTAGCG	L:T:CD8:EM
CTCCACACACGTGTGC	L:T:CD4:Naive
GATGATCCAGAGCGTA	L:T:CD4:Naive
GCGATCGTCGCACGAC	L:T:CD4:Naive
GGCGTCAGTTCAGGTT	L:T:CD4:Naive
TCGAAGTCACCGTACG	L:NK
TCGACGGAGAGAACCC	L:T:CD4:CM
TCGCTTGAGCCAACCC	L:T:CD4:CM
TCGTCCATCAGACTGT	L:NK
TGCGACGGTGTTAAAG	L:T:CD8:EM
TGTAGACGTCGAATTC	L:T:CD4:Naive
TGTCCTGCAGTAGTGG	L:T:CD8:EMRA
TTGACCCAGACTCTTG	L:T:CD8:EMRA
TTGCATTGTCGCGTCA	L:T:CD4:Naive
TTGGGCGAGTGTAGAT	L:T:CD8:EMRA
AAGTCGTGTTCATCGA	L:T:CD8:EMRA
AGGAATAGTATGAAAC	L:T:CD4:Naive
CACTGTCGTTTGTTCT	L:T:CD4:Naive
CCAATGATCGCCGTGA	L:T:CD4:CM
CCATCACTCGCAGATT	L:T:CD8:EMRA
CCGGTAGCAACGGCCT	L:T:CD4:Naive
CGGTCAGCACGCGTGT	L:T:CD4:CM
CGTGAATTCTACTCAT	L:T:CD4:CM
CGTGATACACGTAGAG	L:T:CD4:Naive
CTCAGTCGTGTGCTTA	L:T:CD4:Naive
GAGTGAGAGCTGAGCA	L:T:CD4:Naive
GGACGTCGTTGCACGC	L:T:CD4:CM
GGCGTCACATTCGATG	L:T:CD4:CM
GTCGAATCACCGCTAG	L:T:CD4:CM
GTCTGTCAGCGGACAT	L:T:CD4:CM
TAAGCGTCACCGTGCA	L:T:CD4:Naive
TCCGATCGTGACGTCC	L:NK
TCGAAGTGTGCTCGTG	L:T:CD8:EMRA
TCTACATTCTTGCAGA	L:T:CD4:Naive
TCTCAGCGTCAGTCGC	L:T:CD8:Naive
TGAGCGCGTCACAGAG	L:T:CD4:Naive
AACCACAGTCGCGTCA	L:T:CD4:Naive
AAGAACATCGTGTCAA	L:T:CD4:Naive
ATGATCGTCCTAGCGG	L:T:CD4:Naive
CATTTCAGTCGCGTCA	L:T:CD4:Naive
CGAGTGCCAAGACCGA	L:T:CD4:Naive
CGATGCGGTAGGTCAG	L:T:CD8:EMRA
CGGAATTGTACATACC	L:T:CD8:EMRA
CGTAAGTGTTGAGAGC	L:T:CD4:CM
CGTGCTTTCAAGTGTC	L:NK
CGTGCTTTCAGACCTA	L:T:CD4:CM
CTCAAGAAGTGCTACT	L:T:CD4:Naive
GACCTTCTCCCATAAG	L:T:CD4:CM
GCTACAAAGCATGCGA	L:NK
GGATGTTTCATAGGCT	L:T:CD8:EMRA
GGCGTCAAGTGAACAT	L:B
GTCAGCGTCATTATCC	L:T:CD8:EM
GTCTCACCAGCAGACA	L:NK
GTCTTTAAGCGACCCT	L:T:CD4:Naive
TCCACCATCGCGCCAA	L:B:PC
TCGTAGAAGGCCCGTT	L:T:CD4:CM
TGCTCGTGTACGACTT	L:T:CD4:CM
TGTGGCGCACCGAATT	L:T:CD8:Naive
AAGTCGTGTGACTGAG	L:T:CD8:EM
AGAAGCGTCCATAGGT	L:T:CD4:CM
ATCACAGGTCGCGTCA	L:T:CD8:Naive
ATCGTGACATACTGTG	L:T:CD4:CM
CCGGTAGGTGAGAACC	L:T:CD4:Naive
CTAGGTAAGCGTCTGC	L:T:CD4:EM
CTGTCGTTCCTCTAGC	L:T:CD4:CM
GTGATGTAGCGATCGA	L:T:CD8:CM
TAACGACAGCGTCTGC	L:T:CD4:CM
TACCCGTGTTGGGTAG	L:T:CD4:Naive
TATCGCCTCACCTACC	L:T:CD8:EMRA
TCAGGTACACCCTGTT	L:T:CD4:Naive
TCGAACATCTGGCCGA	L:T:CD4:Naive
TCGCTTGCATGCAGCC	L:B:PC
TCGGATACAAGCACAG	L:T:CD4:CM
TCGGGCAAGATGGCAC	L:T:CD8:EMRA
TGCTGAACAGAATTCC	L:T:CD4:Naive
TGTGATGGTGTCATCA	L:T:CD8:EMRA
TTCTGTAGTTCAAGTC	L:T:CD8:EM
TTGACCCAGGCGAAGG	L:T:CD4:Naive
TTGACCCAGTCCGTCG	L:T:CD4:CM
TTTCCTCAGCAAATGT	L:T:CD8:Naive
ACGGAAGCATGAGAAT	L:T:CD8:EMRA
ACGGTTATCAAGAATG	L:T:CD4:CM
ACGTAACAGGAGTCTG	L:T:CD8:EMRA
ACGTCCTGTGGACTGA	L:T:CD4:Naive
ACTTTCAAGCGTTCCG	L:T:CD4:CM
ATGCCTCAGTCCTGTA	L:T:CD8:CM
CATTGAGCATTAAAGG	L:T:CD4:CM
CCCGAAGGTAGATGTA	L:T:CD4:Naive
CCGGTGACAACTCGTA	L:T:CD4:EM
CCTACGTCATGATAGA	L:T:CD4:Naive
CGATGGCCATAGGCGA	L:T:CD4:Naive
CGGGCATGTTTGGAGG	L:T:CD8:EMRA
CGTCAAACATCCAACA	L:T:CD8:EM
CTGCAGGTCGTCTAAG	L:T:CD4:Naive
GCAACCGTCGTTCCTG	L:T:CD4:CM
GTCACTCGTCAGGCAA	L:T:CD4:CM
GTCATGATCGTCTAAG	L:T:CD4:Naive
TAAGCGTTCTTCCAGC	L:T:CD8:Naive
TACCTCGTCAGACCGC	L:T:CD4:CM
TCACTATAGAAGAGCA	L:T:CD4:Naive
TCAGGGCTCCAGTGTA	L:T:CD8:EM
TCGACGGCATAGGAGC	L:T:CD4:CM
TCGCTTGGTACTAAGA	L:T:CD8:EMRA
TCGGGCACATCCCGTT	L:T:CD4:Naive
TCGTCCATCTGAGGCC	L:T:CD8:EMRA
TCTCACGCACGTCGGT	L:T:CD4:Naive
TGCAGTATCTACTATC	L:T:CD4:CM
TTATTGCGTCTACATG	L:T:CD4:Naive
TTGCGTCAGAGTCTTC	L:T:CD4:Naive
AGGTTACTCAGACCCG	L:T:CD8:EMRA
ATACTTCAGGTATAGT	L:T:CD4:CM
ATCGTGATCCGTCACT	L:T:CD4:Naive
ATTCAGGGTACGCGTC	L:T:CD8:EMRA
ATTCCTAAGTCTAGAA	L:T:CD8:EM
CAACGATAGCGTGCTC	L:T:CD8:EM
CATGCAAAGTCTACCA	L:T:CD4:Naive
CCGATGGAGAGCCTGA	L:T:CD8:Naive
CGATCGGCAAGAGATT	L:T:CD4:Naive
CGATGCGCAGTGTACT	L:T:CD8:EMRA
CGGGTCATCGGACAAG	L:T:CD4:CM
CGGTCAGCATCGGATT	L:T:CD4:CM
CTCAAGATCTTAGGAC	L:T:CD4:EM
GAAGCCCGTGGTCTTA	L:T:CD4:CM
GCACTAAAGCCTCTCT	L:T:CD8:EM
GTAGGTTCAGCGGTCT	L:T:CD8:CM
TAGGTTGGTGCTTCAA	L:T:CD4:Naive
TATCGCCTCGCAGTCG	L:T:CD8:EMRA
TCACACCGTAGTCCTA	L:T:CD4:CM
TCACGGGTCAGCGCGT	L:T:CD8:EMRA
TCATACTGTACGTAGG	L:T:CD4:CM
TCATGTTTCGAAATCC	L:T:CD4:Naive
TCCATCGCAGAGTTCT	L:T:CD4:CM
TCCTCCCAGATCCCGC	L:T:CD4:Naive
TCCTTTCGTAGAGCTG	L:T:CD8:EMRA
TCGCACTAGACAACAT	L:T:CD4:Naive
TCGCTCAAGACTCCGC	L:NK
TCTCTGGTCATGACAC	L:T:CD8:Naive
TCTTGCGAGAAGGCTC	L:T:CD4:Naive
TGATCAGGTACCGTCG	L:T:CD4:Naive
TGTAAGCCAAAGTGTA	L:T:CD4:Naive
TGTGGCGTCCACAAGT	L:T:CD4:CM
TTCGCTGCAGAGGCAT	L:T:CD4:Naive
TTTGGTTCAAGATGGC	L:T:CD8:EMRA
AAGAACAGTTCGGACC	L:T:CD4:Naive
ACGCACGAGTAGTCAA	L:T:CD4:CM
ACGGAAGAGTCCCGGT	L:T:CD8:EM
AGTTCGAGTTGAGAGC	L:T:CD4:Naive
ATAGGCTCAACGACAG	L:T:CD4:CM
ATCGTGACAAAGGTTA	L:T:CD8:EMRA
ATCGTGATCCGTGGTG	L:T:CD4:EM
CACAGATTCACCGGGT	L:T:CD4:Naive
CAGGGCTTCGGCCTTT	L:T:CD4:CM
CAGGTATTCACGGTCG	L:T:CD4:Naive
CAGTGCGCAGGAGACT	L:T:CD4:CM
CCTCAACGTCCGGTCA	L:T:CD4:CM
CCTGTTGTCGCCGTGA	L:T:CD8:EMRA
CCTTGTGTCGGCATTA	L:T:CD4:CM
CGAGGAAAGGTCATTC	L:T:CD8:EMRA
CGTCAAATCGCTGACG	L:B:PC
GATGACTGTCGCTTAA	L:T:CD4:CM
GATGGAGAGGTACTGG	L:T:CD4:CM
GCACGGTAGTACTCGT	L:T:CD4:Naive
GCATCGGTCCGTCCTA	L:T:CD4:Naive
GGAGCAAAGAAACTCA	L:T:CD4:CM
GGATGTTTCGTCGCTT	L:B:PC
GTATTTCAGCGCCGTT	L:T:CD4:Naive
TACGTCCTCTCCTGCA	L:B:PC
TCAAGCAGTAAGCTCT	L:T:CD4:Naive
TCCGTGTTCTTGGTCC	L:T:CD8:EMRA
TCGAACAAGCACGTCC	L:T:CD4:CM
TCGGATAAGTGAGTGC	L:T:CD4:Naive
TCTCACGCATTGCTTT	L:T:CD4:CM
TCTCACGTCACAGTGT	L:T:CD8:EM
TCTCTGGGTTTCGTAG	L:T:CD4:Naive
TCTTGCGAGGACTATA	L:T:CD4:Naive
TGAGCGCTCTATTTCG	L:T:CD4:Naive
TGGGTTAAGCCTGGAA	L:NK
TGTACAGGTTTAGAGA	L:T:CD4:Naive
TGTAGACAGGGACTGT	L:T:CD8:EM
TTGCGTCTCAGACATC	L:T:CD4:Naive
AATGCCACAGGTGGAT	L:T:CD4:Tfh
ACATGCAGTTCTGAGT	L:T:CD4:Naive
ACTATTCGTGCACGCT	L:T:CD4:Naive
AGAACAAGTGGTCTGC	L:T:CD4:CM
AGGGTTTCATTGCTGA	L:B
ATACTTCAGGTAGATT	L:T:CD4:Naive
ATCGGCGTCTCGTTTA	L:T:CD4:CM
CACCAAATCTGGTGGC	L:T:CD4:Naive
CAGAGCCTCTTCTTCC	L:T:CD8:EM
CAGCGTGGTGTTAAAG	L:T:CD4:Tfh
CCACTTGTCCTAGCGG	L:T:CD4:Naive
CCGGTAGAGCTTGTTG	L:T:CD4:CM
CCGTGAGTCGCTGCGA	L:NK
CGCCAGATCGAGAAGC	L:T:CD4:Naive
CGGAACCTCCGCAGTG	L:T:CD8:EMRA
CGTCCATAGGCTAGCA	L:T:CD8:EMRA
CGTGAATAGCTGGAGT	L:T:CD4:CM
CGTTAGAGTATGAGCG	L:T:CD8:EM
CTCAACCGTCGGTACC	L:T:CD4:Naive
CTCCACAGTACCCGCA	L:T:CD8:EMRA
CTCCGATAGGTAAGAG	L:T:CD4:Naive
CTGAGGCTCACATACG	L:T:CD4:CM
CTGCATCAGGGTCACA	L:T:CD4:CM
CTGCTCACACTGAGGA	L:T:CD4:CM
GATGTTGGTACCGCGT	L:T:CD4:Naive
GGAAGTGGTGGCTACC	L:T:CD4:CM
GGCTTGGTCCTATTTG	L:T:CD4:Naive
GTAGTACGTTGTGGCC	L:T:CD4:CM
GTCATGAGTTCCGTTC	L:B:PC
GTGTAACAGCAACAGC	L:T:CD4:EM
GTGTGGCCAAGAGTAT	L:T:CD4:Naive
TACGCTCTCCGCAACG	L:T:CD8:EMRA
TCCATCGAGAGTCAGC	L:T:CD8:EM
TCGATTTAGTAGCCAG	L:T:CD8:EMRA
TCGGATAAGCTCCATA	L:T:CD4:Naive
TCGGGACAGCTTGTTG	L:B:PC
TCTCTGGCAAGTGGTG	L:T:CD4:Naive
TGAGCGCTCGGCCCAA	L:NK
TGGTACATCGTTCCCA	L:T:CD4:CM
TTCACCGGTCTGTGTA	L:T:CD4:Naive
TTCACGCCAGAGTCAG	L:T:CD4:Naive
TTCCGGTGTTGTGGAG	L:T:CD8:Naive
TTGGGCGAGGGTGAAA	L:T:CD4:CM
TTTCACATCCGAGATT	L:T:CD4:Naive
TTTGGTTAGAGATGCC	L:T:CD8:Naive
AACCTTTCAACTTCTT	L:T:CD8:EM
AAGAACACACAAGTTC	L:T:CD4:Naive
AAGACAAAGCGTATAA	L:T:CD4:CM
AAGTCGTAGTACAACA	L:T:CD8:Naive
ACACGCGAGCGTATGG	L:T:CD4:CM
ACTACGACAGTTTCGA	L:T:CD4:Naive
AGAGCAGTCAAGTTGC	L:T:CD4:CM
AGATCGTCAACTCCAA	L:T:CD8:Naive
AGCGTATAGACGACTG	L:T:CD8:EMRA
AGGAATAGTTGCGGAA	L:T:CD8:EMRA
AGGACGATCGTGGCTG	L:T:CD4:Naive
ATCGGATAGCTGAAGC	L:T:CD4:Naive
ATCGTCCTCAGCTGAT	L:T:CD4:Naive
ATCTTCAAGTTGCGCC	L:NK
ATTCCCGGTAGAATGT	L:T:CD8:Naive
CAACAGTAGGTGCTAG	L:T:CD4:Naive
CACAGATCACCAATTG	L:T:CD4:Naive
CATACTTCACACAGCC	L:T:CD8:Naive
CATTGCCGTTAATGAG	L:NK
CCAAGCGTCATTTACC	L:NK
CCCTGATAGAACTTCC	L:T:CD4:CM
CCTCAGTAGCGACTGA	L:T:CD4:Naive
CCTCCTCAGTTCATGC	L:T:CD4:Naive
CGACAGCCATCCGATA	L:NK
CGTTGGGGTACAAGCG	L:T:CD4:Naive
CTCAACCTCGTTCGCT	L:T:CD4:EM
CTGAGCGCACCAGCTG	L:T:CD4:Naive
CTGTGGGTCTACCACC	L:T:CD8:Naive
CTTCTAAGTCGTCTCT	CD34
GAAGCCCGTATGCTTG	L:T:CD4:CM
GACTCAACATTGAAGA	L:T:CD4:CM
GATAGCTAGTCCGTCG	L:T:CD8:EMRA
GCACTAATCGGCATCG	L:T:CD8:EM
GCTGCAGCACGGTCTG	L:T:CD8:EMRA
GGAGCAAGTGGCTTGC	L:T:CD4:Naive
GGGACTCCATAGACTC	L:T:CD4:CM
GTCATGACATGGGTTT	L:T:CD4:Naive
GTCTTTACACCAACAT	L:NK
GTCTTTATCAGTGGGA	L:T:CD8:Naive
GTTCGCTGTCTGTGTA	L:T:CD4:CM
GTTCGCTTCTTCTTCC	L:T:CD4:Naive
GTTGCGGCAAGAGGTC	L:T:CD4:CM
GTTGCGGGTGGCTAGA	L:T:CD4:CM
TAAGCGTAGCCTGTCG	L:T:CD4:CM
TAGGAGGGTGAGTAGC	L:T:CD4:CM
TATCAGGCAGGTCAGA	L:T:CD8:EM
TATCTGTCAAGACCTT	L:T:CD8:EM
TATCTGTGTATTCCGA	L:B:PC
TCAATTCGTTTCGTTT	L:T:CD4:CM
TCATTCAAGTTGCCTA	L:T:CD4:CM
TCCCAGTTCGAGGCAA	L:T:CD4:Naive
TCCTCGACAAGGCTTT	L:T:CD4:CM
TCGAAGTTCGCGATCG	L:T:CD4:CM
TCGGGTGCAAATGATG	L:T:CD4:Naive
TGCAGGCAGCGCCCAT	L:T:CD4:Naive
TGCATGATCATCGCCT	L:T:CD4:CM
TGCGACGTCCGTTGGG	L:T:CD8:CM
TGGGTTAGTGTCGATT	L:T:CD4:CM
TTACCGCGTCACTAGT	L:T:CD8:Naive
TTCGCTGTCGACATCA	L:T:CD4:CM
TTCTTGAAGCTTAGTC	L:T:CD4:Naive
TTGCGTCAGTATTAGG	L:T:CD8:EMRA
TTGCTGCTCCTCTGCA	L:T:CD4:EM
TTGGGCGGTCGTGGAA	L:T:CD8:EMRA
TTTGTTGCAGTTCCAA	L:T:CD8:EMRA
AAATGGACACTGAGGA	L:T:CD4:CM
AACAAGAAGCGCCTTG	L:T:CD8:EMRA
AACAGGGGTGAAGCTG	L:T:CD4:CM
ACCCAAAGTCTACAAC	L:T:CD8:EMRA
ACTACGATCGTTCTCG	L:T:CD4:CM
ACTATCTGTTGTCTAG	L:T:CD8:EMRA
ACTCCCAGTGCCGTTG	L:T:CD4:CM
AGAACCTTCGGTCTGG	L:T:CD4:CM
AGATCGTAGAGCATTA	L:T:CD4:Naive
AGATGAAAGTAAGACT	L:T:CD4:Naive
AGCATCACATCATTGG	L:T:CD4:CM
AGCGCTGGTGATACTC	L:T:CD8:EMRA
AGGATCTCATCCGCGA	L:T:CD4:Naive
AGGCATTGTTCCATTT	L:T:CD4:EM
AGGTCATGTGCAACAG	L:T:CD4:CM
ATAGACCAGGTCTACT	L:T:CD4:EM
ATCACAGCAGATCCTA	L:T:CD8:EMRA
ATTCAGGCAAGGTCTT	L:T:CD4:CM
CACGGGTCAGGAACCA	L:T:CD4:Naive
CATGCTCGTGTGTCCG	L:T:CD4:Naive
CATTCTAGTACTGGGA	L:T:CD8:EM
CATTTCACAGTCCCGA	L:T:CD4:EM
CCGGGTAAGACTTAAG	L:T:CD4:CM
CCTAAGACATTGGCAT	L:T:CD4:CM
CCTCAGTAGGTGGTTG	L:T:CD8:EMRA
CGACAGCGTGAGCTCC	L:T:CD8:EMRA
CGATGGCTCATTACCT	L:T:CD4:Naive
CGCCAGATCGTGCACG	L:T:CD8:EMRA
CGCGTGAGTGACTGAG	L:T:CD8:EMRA
CGGCAGTCACATAGCT	L:T:CD8:EMRA
CGGGTCATCAGCTGTA	L:T:CD4:CM
CGTGAATCATGAGGGT	L:NK
CTCCATGCAACACGTT	L:T:CD4:CM
CTCGAGGGTTGGTACT	L:T:CD4:Naive
CTGAGGCCAACAAGTA	L:T:CD4:Naive
CTTCAATCAGAATCGG	L:T:CD4:CM
GACCCAGAGCCTCAAT	L:NK
GATAGAAAGGCCTTGC	L:T:CD4:CM
GCAACATTCGCGTAGC	L:T:CD4:CM
GCAACCGGTACGAGCA	L:T:CD4:CM
GCCGATGGTACGGATG	L:T:CD8:EM
GCGATCGAGACGACTG	L:T:CD4:CM
GCTGGGTCACAGCATT	L:T:CD4:Naive
GGATCTAAGGGCAACT	L:T:CD4:EM
GGCAGTCCAAGTTGGG	L:T:CD4:CM
GGCGTCATCTCAATCT	L:T:CD4:CM
GGGATGATCAACCGAT	L:T:CD8:Naive
GGTGTTAAGTCATGGG	L:B:PC
GTAGTACTCCCTTTGG	L:T:CD8:EM
GTCCACTAGCAATAGT	L:T:CD8:EM
GTCGTTCTCGACTCCT	L:NK
GTGCTGGAGAGACAAG	L:T:CD8:EMRA
GTGGTTACAAGGTCAG	L:T:CD8:EMRA
GTGTTAGTCCATCGTC	L:T:CD4:Naive
GTGTTCCAGATGCAGC	L:T:CD8:CM
GTTAGTGAGACTACCT	L:T:CD8:EMRA
GTTATGGGTCACAATC	L:T:CD4:CM
GTTATGGTCCTGTTGC	L:T:CD4:Naive
GTTCCGTGTACGTTCA	L:T:CD8:Naive
GTTCTATGTACGTACT	L:T:CD4:Naive
TACCTCGAGTGGCGAT	L:T:CD8:EM
TAGGGTTCAGCACGAA	L:T:CD4:CM
TATTGCTAGAGAGCAA	L:T:CD8:EMRA
TCAGTCCCATGATCTG	L:T:CD8:EMRA
TCATGTTTCTTGGAAC	L:T:CD4:CM
TCATTGTCAAGCGATG	L:T:CD4:CM
TCCGAAAAGTGAGGTC	L:T:CD4:Naive
TCCTTCTAGTAGCATA	L:T:CD8:EMRA
TCGCTTGTCTAGTACG	L:T:CD8:Naive
TCGGATACACTCTAGA	L:T:CD8:EMRA
TCTTGCGCAATACCTG	L:T:CD8:EMRA
TCTTTGATCGTCACCT	L:B:PC
TGGGAAGAGACATCAA	L:T:CD4:Naive
TGGGTTATCGAAGGAC	L:NK
TTACGTTAGGAGCTGT	L:T:CD4:CM
TTACTGTAGCGCCTCA	L:T:CD4:CM
TTCACGCCAGGCATTT	L:T:CD4:CM
TTCAGGACAAGTGATA	L:T:CD4:CM
TTCCAATTCAGGGTAG	L:T:CD8:EMRA
TTCCGTGTCGTTGTTT	L:T:CD8:Naive
TTTCCTCAGCTGCCAC	L:T:CD4:CM
TTTGATCGTGTTACAC	L:T:CD4:Naive
AACCACAAGTATGCAA	L:T:CD4:CM
AAGATAGAGCGTGCCT	L:T:CD4:CM
AAGTGAATCAACACGT	L:T:CD4:CM
AAGTTCGTCGGACTGC	L:T:CD8:EMRA
ACAAGCTGTACTTGTG	L:B:PC
ACCTACCAGGTTCAGG	L:T:CD4:CM
ACTGTGACATCACAGT	L:T:CD8:EM
ACTTTGTAGGTAGATT	L:T:CD4:Naive
ACTTTGTCAACTAGAA	L:T:CD4:EM
AGAAATGTCGGCATAT	L:T:CD8:Naive
AGCGTATGTGAATAAC	L:T:CD8:EM
AGGCTGCCAATACGAA	L:T:CD4:CM
AGTTCGAAGAGTGTTA	L:T:CD4:Naive
ATCGGATTCTAGCCAA	L:T:CD4:Naive
ATTCCCGAGGAATTAC	L:T:CD8:Naive
CATGGTATCAACCTCC	L:T:CD4:Naive
CATTGCCGTCTCTCAC	L:T:CD4:CM
CCAATTTTCAATGCAC	L:T:CD4:Naive
CCATAAGTCTACTCAT	L:T:CD4:Naive
CCCTAACTCGGACCAC	L:T:CD4:CM
CCGAACGCATGGCACC	L:NK
CGATGCGAGTATCTGC	L:NK
CGCGTGATCGGAAACG	L:T:CD8:CM
CGTAATGGTCCTCCTA	L:T:CD4:EM
CGTAGTAGTTTCTATC	L:T:CD4:Naive
CGTGAATAGTATGGCG	L:B:PC
CGTGCTTCATCACAGT	L:NK
CGTTCTGGTGCATGTT	L:T:CD8:EM
CTACGGGTCGTCTACC	L:T:CD4:Naive
CTCATGCTCGGTCTGG	L:T:CD4:Naive
CTCCCTCGTCTTAGTG	L:T:CD8:EMRA
CTTACCGGTGGACTAG	CD34
CTTCCGAAGTCCCGAC	L:T:CD4:CM
CTTTCGGGTGCGACAA	L:T:CD8:Naive
GAGTGTTTCTCCGAAA	L:NK
GATAGCTCAGATTAAG	L:T:CD4:Naive
GCCATGGTCCCGTGTT	L:T:CD8:EMRA
GGCGTCAAGAGAACCC	L:T:CD8:EMRA
GGGTCTGGTCCTTTGC	L:T:CD8:Naive
GGTGTTATCGCGTTTC	L:T:CD4:CM
GTAACACAGCTGTCCG	L:T:CD4:Naive
GTCAGCGAGGCTCAAG	L:T:CD8:EMRA
GTGGTTAGTGTTGAGG	L:T:CD8:Naive
GTGTGATCAGGATTCT	L:T:CD8:EMRA
GTTCCGTCATCGGATT	L:T:CD4:EM
GTTCTATAGGAATCGC	L:T:CD4:EM
GTTGCGGAGTCGAAAT	L:T:CD4:Naive
GTTGTGATCCGATCGG	L:T:CD4:CM
TACCGGGAGCCTGAGA	L:T:CD4:EM
TATACCTGTTCGATTG	L:T:CD4:Naive
TCAGCAATCCGACAGC	L:T:CD4:CM
TCAGTCCTCATAGACC	L:T:CD8:EMRA
TCCACGTAGGTAAGTT	L:T:CD8:EM
TCCCACAAGGTCATTC	L:T:CD4:CM
TCGCACTCATGTTCAG	L:T:CD8:EMRA
TCGGTCTCAAGTGGGT	L:T:CD4:CM
TCTCTGGCATGCCGGT	L:T:CD4:CM
TCTTGCGGTGTCCACG	L:T:CD8:EM
TGCGACGTCTCTGCTG	L:T:CD8:EMRA
TGGGCGTTCCGCTAGG	L:T:CD8:EMRA
TGTTCCGTCGTCTACC	L:T:CD4:Naive
TTCTTCCAGCATCAGG	L:T:CD4:CM
TTGGTTTGTGGCTTAT	L:T:CD4:CM
TTGTGGATCCTTGACC	L:T:CD8:EMRA
TTGTGGATCTCGTGAA	L:T:CD4:CM
TTGTGTTAGCGGTAGT	L:T:CD8:EMRA
TTGTTTGCAGTCGAGA	L:T:CD8:EMRA
AAAGTGAGTGACGCCT	L:T:CD4:Naive
AACAACCAGAAGCCTG	L:T:CD4:CM
AAGGAATGTCCTGGTG	L:T:CD4:Naive
ACAAAGATCACCGGTG	L:NK
ACCCTTGGTAACAAGT	L:T:CD4:Naive
ACCCTTGTCTCTTCAA	L:T:CD4:Naive
ACCTACCCATTCATCT	L:T:CD4:Naive
ACCTGAAGTAACACGG	L:T:CD4:CM
ACGGTCGTCCGAGGCT	L:T:CD8:EMRA
ACTGTCCTCTCTTGCG	L:T:CD4:CM
AGAGAATTCCAGCTCT	L:T:CD8:Naive
AGCTCAAGTCTCGACG	L:T:CD4:CM
AGGAGGTGTACCTGTA	L:T:CD4:CM
AGGAGGTTCTGGTGCG	L:B:PC
AGTGTTGGTCCGGTGT	L:T:CD4:Naive
ATCGTGATCTTCTGGC	L:T:CD4:CM
ATGAGTCGTGAGAACC	L:T:CD4:Naive
ATTCGTTGTTTCCCAC	L:T:CD4:Naive
ATTGTTCTCACCGGGT	L:T:CD8:Naive
ATTTCTGCATCCTATT	L:T:CD8:EMRA
CAACAGTAGATGATTG	L:T:CD8:EMRA
CACGGGTGTAGTCTGT	L:T:CD4:Naive
CACGGGTTCGTTTACT	L:T:CD4:Naive
CACTTCGTCATACGGT	L:B:PC
CATGCGGCAAGCTCTA	L:T:CD4:Naive
CATGGATCAGAGATTA	L:T:CD8:Naive
CCAAGCGGTTGCATGT	L:T:CD8:EMRA
CCACAAAGTTCGTAAC	L:T:CD4:Naive
CCCTTAGGTCGCTTAA	CD34
CCGTAGGGTCGCTTAA	L:NK
CCTCAACGTGATGGCA	L:T:CD8:EMRA
CGAATTGTCTAACGCA	L:T:CD4:Naive
CGAGAAGTCCATTGTT	L:T:CD4:CM
CGAGTGCAGAAGCTGC	L:T:CD8:EMRA
CGCCATTCATGGCGCT	L:T:CD4:CM
CGGAACCCAAGCGGAT	L:T:CD4:CM
CGGGACTAGCGAAACC	L:T:CD4:Naive
CGTAGTACAAGTCGTT	L:T:CD4:EM
CGTGAATTCACTTCTA	L:NK
CTGGACGTCATGTCAG	L:T:CD4:Naive
GACGCTGAGATAGCAT	L:T:CD8:EMRA
GACTGATCATTAAGCC	L:T:CD4:CM
GAGTCTAGTTTCACAG	L:T:CD8:EMRA
GATTGGTTCTCGTGAA	L:T:CD4:CM
GCAGCCAAGTGATAAC	L:T:CD4:CM
GCCATGGAGCGTGTTT	L:T:CD4:Naive
GCTGGGTAGCGCAATG	L:T:CD4:CM
GGGCGTTAGCGTGCCT	L:NK
GGTCACGAGAGCGACT	L:T:CD8:Naive
GTAATCGAGAGGTCGT	L:T:CD4:CM
GTCATCCCACACGGAA	L:NK
GTGTAACAGTAGCAAT	L:T:CD4:Naive
GTTACAGAGACAACTA	L:T:CD4:CM
GTTTACTGTACAGTCT	L:T:CD8:EM
TACATTCTCCGATAGT	L:T:CD8:EMRA
TACGTCCCATATACCG	L:T:CD4:Naive
TAGCACACATGAGATA	L:T:CD4:CM
TCATTACAGGGTTAAT	L:T:CD8:EMRA
TCCGGGAAGCCTCTCT	L:T:CD4:CM
TCGAAGTCATGATCTG	L:T:CD8:EMRA
TCGGGACTCCTAAGTG	L:T:CD4:CM
TCGGTCTTCCAATGCA	L:T:CD4:CM
TCTCCGATCGCCCAGA	L:T:CD4:Naive
TCTTGCGCAAGACTGG	L:T:CD4:Naive
TGCTTCGTCGCGATCG	L:T:CD8:EM
TGGAGAGTCTGGCCGA	L:T:CD4:Naive
TTGAGTGCAGAACATA	L:T:CD4:EM
TTGTTCATCGATTGGT	L:B:PC
TTTGGTTTCTCGAACA	L:T:CD8:Naive
AAACGCTGTAGTCGTT	L:T:CD8:EMRA
AAAGAACAGGCAATGC	L:T:CD4:CM
ACACAGTGTGTCATTG	L:T:CD4:Naive
ACCAAACAGGGCCCTT	L:T:CD4:CM
ACCCTCAAGGCAGGTT	L:NK
ACGTACACATGCAGGA	L:T:CD4:Naive
ACTCTCGGTGTGTCGC	L:T:CD8:EM
ACTGTGAAGCGCTGCT	L:T:CD4:Naive
AGACCCGAGAAGCCAC	L:T:CD4:Naive
AGATCGTGTCGGAACA	L:T:CD4:Naive
AGCGATTTCTACAGGT	L:T:CD4:Naive
AGGCCACAGGACAGCT	L:T:CD4:CM
AGGGCCTCATAAGATG	L:T:CD4:Naive
AGGTCATCAACGGCTC	L:T:CD8:EM
AGGTGTTAGTGGCCTC	L:T:CD4:Naive
ATCACAGCAAGACTGG	L:T:CD4:CM
ATCACAGGTGTGTGTT	L:B:PC
ATCCACCAGCCTGAGA	L:T:CD8:Naive
ATCGCCTTCATTACTC	L:NK
ATCGTAGAGACTCTAC	L:T:CD4:CM
ATCGTGATCTTCCTAA	L:T:CD8:EMRA
ATTACTCCAGGCATGA	L:T:CD8:EMRA
ATTATCCGTAACTTCG	L:B
ATTCACTGTGTTACAC	L:T:CD4:Naive
ATTCACTTCCATTTCA	L:T:CD4:EM
CAACGATGTTATAGAG	L:T:CD4:Naive
CACAGATTCCACTGAA	L:T:CD4:Tfh
CACGTTCAGGGATCAC	L:T:CD4:Naive
CCGGTGAAGGCACAAC	L:T:CD4:CM
CCGTGAGCAAGATGTA	L:T:CD4:Naive
CCTAACCGTTGCGGAA	L:T:CD4:Naive
CCTAAGAAGTTAGTGA	L:T:CD8:Naive
CCTCTAGGTTATGTGC	L:B:PC
CCTGTTGCAGGCCTGT	L:T:CD8:CM
CGAATTGAGCTTGTTG	L:T:CD4:CM
CGATCGGTCAGTGTGT	L:T:CD4:Naive
CGGAACCCAGTGTGCC	L:T:CD4:Naive
CTCCACAAGGAACTAT	L:T:CD8:EMRA
CTCGAGGTCATCGCAA	L:T:CD4:CM
CTGTACCGTGAACTAA	L:T:CD8:EMRA
CTGTACCTCGTTACCC	L:T:CD8:EMRA
GAAGTAATCCGGTTCT	L:T:CD8:Naive
GAATAGATCGGTCAGC	L:T:CD4:Naive
GACGTTAGTAACATGA	L:T:CD8:CM
GCACGTGTCTGCAGCG	L:T:CD8:Naive
GCAGCCACACCGTGGT	L:T:CD4:EM
GCCGATGGTCAGTTTG	L:T:CD8:EMRA
GCGTTTCCAACACGTT	L:T:CD4:Naive
GCTACCTCACTGGAAG	L:T:CD4:Naive
GGAAGTGAGATCCCGC	L:T:CD4:CM
GGGATGAAGGCTCCCA	L:T:CD8:EMRA
GGTTCTCGTACGAAAT	L:T:CD8:EMRA
GTAGTACGTAGTATAG	L:T:CD4:CM
GTCCACTGTTCTTAGG	L:T:CD4:Naive
GTGAGGAGTGTGGACA	L:T:CD4:CM
GTGAGTTAGGCCTAGA	L:T:CD4:CM
GTGGCGTTCTAGGAAA	L:T:CD4:Naive
TAATCTCAGGCTTCCG	L:B:PC
TACTTCACAAACCGGA	L:T:CD4:EM
TAGGAGGTCAACCTTT	L:T:CD4:CM
TATACCTAGGGTTGCA	L:T:CD4:CM
TATTGGGGTGCTCTTC	L:T:CD8:EMRA
TCAAGACCAACCGCCA	L:T:CD4:CM
TCAAGTGCATGTCGTA	L:T:CD4:EM
TCAGTCCCAGTTGTTG	L:T:CD4:Naive
TCATATCTCATTGCGA	L:T:CD4:Naive
TCCGTGTGTGACACGA	L:T:CD8:EMRA
TCCTAATCATTGAGCT	L:NK
TCGACCTGTAGTATAG	L:T:CD4:CM
TCTATCAGTCGCTTGG	L:T:CD4:CM
TCTCACGAGGTAAGGA	L:T:CD8:EMRA
TCTGCCAGTCAAGTTC	L:T:CD4:Naive
TGACCCTGTTGTGGAG	L:T:CD4:Naive
TGATCTTGTCAAGCGA	L:T:CD4:EM
TGCATCCAGCATGTTC	L:B
TGCGGCAGTGTTGAGG	L:T:CD4:CM
TGCTTCGAGGGTGGGA	L:B:PC
TGGATCACAAAGGGTC	L:T:CD8:EMRA
TGGCGTGGTTGTTGTG	L:T:CD4:CM
TGTCCTGAGAAGGATG	L:T:CD8:EMRA
TGTGATGTCTAGCATG	L:T:CD8:CM
TTCCGGTTCAAGCTTG	L:T:CD4:Naive
TTCGCTGGTGAGGAAA	L:T:CD8:EMRA
TTCTAGTCACGCAAAG	L:T:CD8:EMRA
TTCTGTAGTGTCCTAA	L:T:CD4:CM
TTTATGCCAGGACTAG	L:T:CD4:CM
AAAGGTATCAGCCTTC	L:T:CD4:Naive
AAGGAATGTATCGAGG	L:T:CD4:CM
ACACAGTGTCACAATC	L:T:CD8:EMRA
ACATCGACAGTAACAA	L:T:CD4:CM
ACGGAAGTCCTTCTTC	L:T:CD4:Naive
ACTGCAAGTGTACAGG	L:T:CD4:Naive
AGACCATGTGGACTGA	L:T:CD8:EMRA
AGGCCACTCTAAGGAA	L:T:CD8:EMRA
AGGGTGATCCATTTCA	L:T:CD8:CM
AGGTTGTTCGGTATGT	CD34
AGTGTTGAGTATGTAG	L:T:CD4:Naive
AGTTAGCGTCCGTTTC	L:B:PC
ATACTTCAGCGCCTTG	L:T:CD4:EM
ATCACTTTCATAGCAC	L:T:CD4:Naive
ATCAGGTCAGGACAGT	L:T:CD8:Naive
ATGATCGCAGTCGCAC	L:T:CD8:EMRA
ATGGTTGAGTCAGCCC	L:T:CD8:Naive
ATTATCCGTCCACTTC	L:T:CD4:Naive
ATTCCCGCATGGGTTT	L:T:CD4:EM
CAAAGAATCTAGAACC	L:T:CD8:EMRA
CAACAGTCAGGGAGAG	M:Mega
CAATTTCGTCTTCAAG	L:T:CD8:EMRA
CACAACAGTATTCCTT	L:T:CD8:EMRA
CACGAATCACTGGACC	L:T:CD8:EMRA
CACGTGGCAGAAATCA	L:T:CD8:Naive
CAGGGCTGTCTTCCGT	L:T:CD4:Naive
CATCCCATCTCAACGA	L:T:CD4:EM
CATGCAACAGTTGAAA	L:T:CD4:CM
CCAAGCGCATAATCGC	L:T:CD8:EMRA
CCACAAAAGTCTCTGA	L:T:CD4:CM
CCACGAGCATTCTCTA	L:T:CD4:Naive
CCTTCAGCATAATGAG	L:NK
CGAAGTTGTACCCGCA	L:T:CD4:CM
CGAGTTAGTTACTCAG	L:T:CD4:CM
CGGAACCGTCCAAGAG	L:T:CD8:EMRA
CGGCAGTAGCTAGAGC	L:T:CD4:Naive
CGGGCATTCAAGCCAT	L:T:CD4:CM
CGGGTGTCACCCTAAA	L:T:CD8:Naive
CGGGTGTCACTAGAGG	L:T:CD4:Naive
CGTCAAATCACAGTGT	L:T:CD4:CM
CGTCAAATCGCGATCG	L:T:CD8:EMRA
CGTTAGAAGCCATTTG	L:T:CD4:Naive
CTACTATCAATAGAGT	L:T:CD4:Naive
CTCAACCAGATGGCAC	L:T:CD4:CM
CTCATGCAGTGAGGCT	L:T:CD4:Tfh
CTGGTCTTCTAGTCAG	L:T:CD8:EMRA
CTGTGGGTCCTTACCG	L:T:CD4:Naive
CTTCAATTCTACACAG	L:T:CD4:Naive
GACCTTCGTGTGGACA	L:T:CD8:EMRA
GAGTTACTCTAGTACG	L:B:PC
GATTCTTTCTTCGTGC	L:T:CD8:EMRA
GCATCTCAGCCAAGGT	L:T:CD4:CM
GCCAACGCAGCACGAA	L:T:CD4:CM
GCGTTTCAGAGGCTGT	L:NK
GGGATGATCGGTCATA	L:T:CD4:Naive
GGTCACGAGAAACCAT	L:T:CD4:Naive
GGTCACGTCTAAGCCA	L:T:CD4:Naive
GGTGAAGAGAGCATCG	L:NK
GGTGGCTCATGTACGT	L:T:CD4:CM
GTAGGAGGTCCGTACG	L:T:CD8:EMRA
GTATTTCCACTGGCCA	L:T:CD8:Naive
GTCAAACGTGCACGCT	L:B:PC
GTCCACTAGGGCAGAG	L:T:CD4:CM
TAATTCCGTTGGTACT	L:T:CD4:Naive
TATTGGGCACGGGTAA	L:T:CD4:Naive
TCATGGAAGGGAGGCA	L:T:CD8:EM
TCGGTCTTCCGTTGAA	L:T:CD4:CM
TCTTGCGGTGGATTTC	L:T:CD4:CM
TGAATCGGTCTCGGGT	L:T:CD4:CM
TGATCTTAGCTCGAAG	L:T:CD4:Naive
TGCAGGCTCACCTGTC	L:T:CD4:CM
TGCCGAGCAGAACTAA	L:T:CD4:CM
TGCGACGCAAGATCCT	L:T:CD8:Naive
TGCGACGGTGGTCTAT	L:T:CD8:EM
TGCGATAGTCCAATCA	L:T:CD4:CM
TGCGATATCTCAATCT	L:T:CD8:EMRA
TGCTCGTAGGTAAGTT	L:T:CD4:Naive
TGGAACTAGAGGTGCT	L:T:CD4:CM
TGGATGTCATGAATAG	L:T:CD4:CM
TTACCGCTCGTCTCAC	L:T:CD4:Naive
TTACGCCAGCAGGTCA	L:T:CD8:EMRA
TTATTGCCATCTCAAG	L:T:CD4:Naive
TTCCACGTCATTGGTG	L:NK
TTCGATTCATCCGCGA	L:T:CD4:CM
TTGCATTGTGGCATCC	L:T:CD4:Naive
TTGGGTATCGAGAACG	L:T:CD4:Naive
TTTATGCAGTTACGTC	L:NK
TTTATGCGTCCGGCAT	L:T:CD4:CM
TTTGACTGTCCCGGTA	L:B:PC
TTTGATCGTATGGAAT	L:T:CD4:CM
AACGGGATCCCGAGGT	L:T:CD8:EMRA
AAGGAATGTGCCTACG	L:T:CD4:CM
AATTCCTTCCGAACGC	L:T:CD8:EMRA
ACATCCCAGAGGCTGT	L:T:CD4:Naive
ACCTACCGTACAGTCT	L:T:CD4:CM
ACGCACGAGAAGCTGC	L:T:CD4:Naive
ACTATCTGTTCCAGGC	L:T:CD4:Naive
ACTGCAACAGTCCGTG	L:B:PC
AGAGAATTCATTCCTA	L:T:CD8:Naive
AGAGAGCCATCTCGTC	L:T:CD8:EMRA
AGAGAGCTCCAACACA	L:T:CD4:CM
AGAGCCCGTCCTGGGT	L:T:CD4:CM
AGCTACATCTTCGACC	L:T:CD8:EMRA
AGGGTGATCATAGCAC	L:T:CD4:CM
AGTGTTGGTATGGGAC	L:T:CD4:CM
ATACCTTTCCCAACTC	L:T:CD8:CM
ATACTTCGTCGTCATA	L:T:CD8:EMRA
ATAGAGAAGGATATAC	L:T:CD8:EMRA
ATCCATTTCACTGGGC	L:T:CD8:Naive
ATGAGGGGTCGACTGC	L:T:CD4:Naive
ATGCATGAGATGATTG	L:T:CD4:Naive
ATGCGATGTGAGGCAT	L:NK
ATTGGGTAGACTTCCA	L:T:CD4:CM
CAAAGAAAGCCGGATA	L:T:CD4:Naive
CAACGGCAGTTCATCG	L:T:CD4:CM
CATACCCCAATGAGCG	L:T:CD4:Naive
CATCGGGCACAGTATC	L:T:CD4:CM
CATCGTCAGCCTCTGG	L:T:CD8:Naive
CATTCTAAGTGCGACA	L:T:CD4:Naive
CCGATGGAGTTAACAG	L:T:CD4:Naive
CCGGTAGTCACTTCTA	L:T:CD4:Naive
CCGGTAGTCCATTTCA	L:T:CD4:CM
CCGTAGGAGTGAGTGC	L:T:CD8:EMRA
CCGTTCAAGACTCAAA	L:B:PC
CCTCACAGTTCGGTCG	L:T:CD4:EM
CGAGGAAGTCTGATAC	L:T:CD8:Naive
CGGGACTGTTACACTG	L:T:CD8:EMRA
CGTAAGTCATGTTTGG	L:T:CD8:EMRA
CGTGAATCAGACGATG	L:T:CD4:Naive
CGTTCTGTCGGAGTAG	L:T:CD4:CM
CGTTGGGGTCTACAGT	L:T:CD8:EMRA
CTAACCCAGAAGAACG	L:T:CD4:CM
CTCACTGAGTCATGAA	L:T:CD4:CM
CTCAGAACAAGGTCGA	L:T:CD8:EMRA
CTCATGCGTCATGACT	L:T:CD8:CM
CTCATGCTCTGACGCG	L:T:CD4:Naive
CTGTAGACAAATGATG	L:T:CD4:EM
CTGTCGTCAGGGAGAG	L:T:CD4:CM
GACATCAAGGCTTTCA	L:T:CD4:CM
GACCAATTCCATAAGC	L:T:CD8:EMRA
GACCGTGCACAGCTTA	L:T:CD8:EM
GAGACCCCAACGGCCT	L:T:CD8:EMRA
GATCATGCAGCCGGTT	L:T:CD4:CM
GATTGGTCACGGCGTT	L:T:CD8:EM
GCAGCCACAGCATACT	L:T:CD8:EMRA
GCCTGTTTCAGCATTG	L:T:CD4:Naive
GCGAGAAAGGGTATAT	L:T:CD8:Naive
GCGAGAAGTGTAACGG	L:T:CD4:Naive
GCGTTTCAGTCATTGC	L:T:CD8:Naive
GCGTTTCCAGCGGTTC	L:T:CD8:EMRA
GGAGAACTCTAGCCAA	L:T:CD8:EMRA
GGCAGTCGTTAGGGTG	L:T:CD8:EMRA
GGCTTGGGTACTAGCT	L:T:CD4:CM
GGTAACTAGCGATCGA	L:T:CD4:Naive
GGTGATTGTATGAGCG	L:T:CD4:CM
GGTGGCTTCAGACCGC	L:T:CD4:CM
GTAAGTCAGCAGTACG	L:T:CD8:EMRA
GTACAACGTAGGAGGG	L:T:CD8:EMRA
GTAGAAAGTAAGATTG	L:T:CD8:Naive
GTAGGTTTCGAACGCC	L:T:CD4:Naive
GTCAAGTCAGGATCTT	L:T:CD4:CM
GTCAGCGAGTAGTGCG	L:T:CD4:Naive
GTCTGTCAGGTTCCGC	L:T:CD8:EMRA
GTGCACGCAATTGGTC	L:T:CD4:Naive
GTTCATTAGAGCAGTC	L:T:CD4:Naive
GTTGCTCGTACCTATG	L:T:CD4:CM
TAACGACGTGTCATTG	L:T:CD4:Naive
TAACTTCAGTGGCCTC	L:T:CD8:EMRA
TACCGAATCTGCAGCG	L:T:CD8:EMRA
TCACGCTTCTGTCGCT	L:T:CD4:CM
TCAGGGCAGCTCCATA	L:T:CD4:Naive
TCAGGTACATCTATCT	L:T:CD4:EM
TCATGAGTCGACCACG	L:T:CD8:EM
TCATTGTTCTACGGTA	L:T:CD4:CM
TCCAGAATCTCTCGAC	L:T:CD8:EMRA
TCCATGCAGTGATGGC	L:T:CD4:CM
TCCGGGACAAGTTCCA	L:T:CD4:CM
TCCGGGACATAATGCC	L:T:CD8:EMRA
TCCTCCCAGGTATTGA	L:T:CD4:CM
TCGATTTCAACACAGG	L:T:CD4:Naive
TGACCCTAGCATGGGT	L:T:CD8:EMRA
TGAGACTGTCAGATTC	L:T:CD4:CM
TGAGGTTAGGTGCTGA	L:T:CD4:Naive
TGCAGGCTCGTGGACC	L:B:PC
TGCGACGCAAGTCCCG	L:T:CD8:Naive
TGGAGGAGTACATACC	L:T:CD4:EM
TGGAGGATCACATCAG	L:T:CD4:Naive
TGGGAAGCAGCACCCA	L:T:CD8:EM
TGGGAGACAGACGCTC	L:T:CD4:CM
TGTAAGCCAACGACAG	L:T:CD4:CM
TGTACAGTCTCAGTCC	L:T:CD8:CM
TGTTCATAGTGGTTGG	L:T:CD4:Naive
TTAGTCTTCCCGAACG	L:T:CD4:Naive
TTCCGGTTCCACGTCT	L:T:CD8:EMRA
TTCGCTGCAGACGCTC	L:T:CD4:EM
TTCTGTATCATTACCT	M:Mega
TTGACCCAGCGTCAGA	L:T:CD4:Naive
TTGAGTGTCTCGGTAA	L:T:CD4:CM
TTGATGGGTTCTCGTC	L:T:CD8:EM
TTGGTTTAGAACTGAT	L:T:CD4:Naive
TTGGTTTTCGGCATAT	L:T:CD8:EMRA
TTTACGTCATGTCTAG	L:NK
TTTCCTCCAAAGACGC	L:T:CD4:Naive
TTTCGATTCGTCAACA	L:T:CD8:EM
AAACGAATCTGAGATC	L:T:CD8:EM
AAAGGGCCACTCCACT	L:T:CD4:CM
AAAGGTAAGCCGTCGT	L:T:CD4:CM
AACAAAGCAGAATCGG	L:B:PC
AAGATAGAGACAGCGT	L:T:CD4:Naive
AAGCCATAGGAGGTTC	L:T:CD8:EMRA
AATAGAGGTCGATTCA	L:T:CD8:EMRA
AATAGAGTCGGAAGGT	L:T:CD8:EM
ACACCAAAGGTAAAGG	L:T:CD4:CM
ACAGAAATCCACTAGA	L:T:CD8:EMRA
ACCACAACAAATGGAT	L:T:CD4:Naive
ACGATGTAGCAGCAGT	L:T:CD8:EMRA
ACGCACGAGCACCGAA	L:T:CD4:CM
ACGGGTCCACGTAGAG	L:T:CD8:EM
ACGTTCCAGGTGCATG	L:T:CD8:EMRA
ACTCTCGGTCTGTGGC	L:T:CD4:Naive
ACTTCCGAGTTTCTTC	L:T:CD4:EM
ACTTTGTCAGATACTC	L:T:CD8:CM
AGACTCAGTCGTGCCA	L:T:CD8:EMRA
AGCTTCCGTCTTGCTC	L:T:CD4:EM
AGGCCACAGGAACGTC	L:T:CD4:Naive
AGTAGCTGTAGATTGA	L:T:CD4:Naive
ATAGAGAGTATGAGGC	L:T:CD4:CM
ATCACGATCCCGTTCA	L:T:CD8:EM
ATGATCGGTAGTCGTT	L:B
ATGGGAGGTCGACTTA	L:T:CD8:Naive
ATTCTACGTCTCGCGA	L:T:CD8:EMRA
ATTCTTGAGAAATGGG	L:T:CD8:Naive
CAAGCTAGTACCGTCG	L:T:CD8:EMRA
CACGTTCTCATGAGAA	L:T:CD4:CM
CAGGCCAGTTGCATCA	L:T:CD8:CM
CAGGTATAGTTTCTTC	L:T:CD4:CM
CATAAGCGTATCGAAA	L:T:CD8:Naive
CATCCGTTCTCGGTAA	L:T:CD4:CM
CATGCAACAAGAGGCT	L:T:CD4:Naive
CATGCGGCACCGTGGT	L:T:CD4:Naive
CCCGAAGTCCCATTTA	L:T:CD8:EM
CCCGGAATCCGTATAG	L:T:CD4:CM
CCGGTAGGTCATCAGT	L:T:CD4:CM
CCTAACCGTGTGTGTT	L:T:CD8:Naive
CCTCACATCTGGGCAC	L:T:CD4:Naive
CGAGGCTAGGCTCACC	L:T:CD4:Naive
CGAGGCTCACGACAAG	L:T:CD4:CM
CGAGGCTTCAGATGCT	L:T:CD8:Naive
CGATGCGGTAGCTCGC	L:T:CD8:EMRA
CGCAGGTTCTAATTCC	L:T:CD4:CM
CGCATAAAGAGGGTGG	L:T:CD4:CM
CGCCATTCATTCGGGC	L:T:CD4:CM
CGGAACCAGGACAGTC	L:T:CD4:Naive
CGGACACAGGAGTCTG	L:T:CD8:EM
CGGACACCACCAGCTG	L:T:CD4:Naive
CGGAGAAAGGATGCGT	L:T:CD8:EMRA
CTACTATAGCGTGCTC	L:T:CD8:EMRA
CTCAACCAGGGATCAC	L:T:CD4:CM
CTCAGAAGTTTGAACC	L:NK
CTCCATGGTTGGATCT	L:T:CD4:CM
CTCCTCCGTGTGCTTA	L:T:CD8:EM
CTCGAGGAGGCTGGAT	L:T:CD8:EMRA
CTGTGGGTCTACGCGG	L:T:CD4:CM
CTTAGGATCGGAAACG	L:T:CD8:Naive
CTTTCAAGTAGGACTG	L:T:CD4:CM
GAAACCTGTCGTCGGT	L:T:CD8:Naive
GAAGCCCGTGGACCAA	L:T:CD8:EMRA
GAATAGAAGTAGAATC	L:T:CD4:Naive
GACAGCCGTAGGTACG	L:T:CD8:EM
GACGCTGAGCATCGAG	L:T:CD4:CM
GAGGGATAGGAACGCT	L:T:CD8:EMRA
GAGTTACGTAACCCGC	L:T:CD4:Naive
GAGTTGTAGCTGACCC	L:T:CD4:Naive
GATGTTGCAGCGTGCT	CD34
GCATGATTCTTACGGA	L:T:CD4:CM
GCCAGCAAGGAACTCG	L:T:CD4:Naive
GCCAGCAAGGAGTCTG	L:T:CD4:CM
GCCAGTGGTCTAACGT	L:NK
GCGGAAACATGTCGTA	L:T:CD4:Naive
GGTAACTCATCTCATT	L:T:CD4:Naive
GGTGGCTAGCGGTAAC	L:T:CD8:Naive
GGTGTTACAACCGTGC	L:T:CD4:CM
GTAACCATCACTTTGT	L:T:CD8:EMRA
GTAGGTTGTCACCGAC	L:T:CD8:EMRA
GTCACGGAGAGGGTGG	L:T:CD4:Naive
GTCCTCAAGCGCCATC	L:T:CD4:EM
GTGCTTCAGGGCTGAT	L:T:CD8:EM
GTGTAACAGCACACCC	L:T:CD4:EM
GTGTTAGGTGGAACCA	L:B:PC
GTTGTCCAGTCTTGGT	L:T:CD4:Naive
GTTTACTCAACAAGTA	L:T:CD8:EMRA
GTTTACTGTGGTGATG	L:T:CD8:EMRA
TAACGACAGCCGCTTG	L:T:CD4:CM
TAATCTCGTACTAAGA	L:T:CD4:EM
TACCTCGGTGGTCTGC	L:T:CD4:Naive
TACCTGCGTGTCACAT	L:T:CD8:EMRA
TACGGGCGTAGTCTTG	L:T:CD8:CM
TACTGCCTCTCCGAGG	L:T:CD8:Naive
TCAAGACTCAGTGGGA	L:T:CD8:EMRA
TCACAAGTCACTCTTA	L:T:CD8:CM
TCACGCTGTCGACGCT	L:T:CD8:EMRA
TCAGCAATCAAGATAG	L:T:CD4:EM
TCAGGGCAGTGAGCCA	L:T:CD4:CM
TCAGGGCTCTTACCGC	L:B:PC
TCAGTGATCCATAGAC	L:T:CD4:CM
TCATACTGTCTTGCGG	L:T:CD4:CM
TCATCATGTGATCGTT	L:T:CD4:Naive
TCCATGCCAGAAACCG	L:T:CD8:EMRA
TCCTCCCCAAGCAATA	L:T:CD8:EMRA
TCCTCTTAGTTTGGCT	L:T:CD8:EMRA
TCCTTCTGTCGTCAGC	L:T:CD4:EM
TCTACATTCTGTCGCT	L:T:CD4:EM
TCTCCGAAGACCAAGC	L:T:CD4:CM
TCTCCGAGTTCGGCGT	L:T:CD4:Naive
TGAGACTCATTGCAAC	L:T:CD4:CM
TGGAACTTCCCTATTA	L:T:CD4:EM
TGGAGAGTCGTGGGTC	L:T:CD4:CM
TGGCGTGGTTCGAAGG	L:T:CD4:Naive
TGGGCGTCAATGTCAC	L:T:CD4:Naive
TGTGATGTCATAAGGA	L:T:CD4:Naive
TGTTCATAGACTTCAC	L:T:CD4:Naive
TTCCAATGTCTTGCGG	L:T:CD4:CM
TTCCAATTCCAACCAA	L:T:CD4:CM
TTCGATTTCACCGGTG	L:T:CD8:EMRA
TTCTTGATCCCATAGA	L:T:CD8:EMRA
TTGCCTGCAACGGGTA	L:T:CD8:EMRA
TTTGACTTCCAACTAG	L:T:CD4:CM
AAAGGGCGTCCCGGTA	L:T:CD8:CM
AAATGGAAGGATGCGT	L:T:CD4:CM
AATGACCCAGGACAGT	L:T:CD4:CM
AATGGAAAGAAACTGT	L:T:CD4:Naive
ACACAGTAGAGAATCT	L:T:CD8:EM
ACGGTCGAGGAGTATT	L:T:CD4:CM
ACGTACAGTAGCGCCT	L:T:CD4:CM
ACGTTCCCAATTGTGC	L:T:CD4:CM
ACTACGAGTCCAGCGT	L:B:PC
AGACAAAGTACGAGTG	L:T:CD8:EM
AGAGAATCAAGGATGC	L:T:CD4:Naive
AGGCATTCAAATAAGC	L:NK
AGGGAGTTCACCTGTC	L:T:CD4:Naive
AGGGCCTTCGGCTATA	L:T:CD8:EMRA
AGGTCTATCTATCACT	L:T:CD4:Naive
AGGTGTTGTTAGTTCG	L:T:CD4:Naive
AGTACCAGTTTGATCG	L:T:CD4:CM
AGTTCGACACCAAATC	L:T:CD4:Naive
ATAGAGAAGAAGTCTA	L:T:CD4:Naive
ATCCGTCTCTGGGTCG	L:T:CD8:EMRA
ATCTCTAGTGAGTCAG	L:T:CD4:CM
ATCTTCACAGTTCCAA	L:T:CD4:Naive
ATGCCTCAGAATCGTA	CD34
ATGGTTGCACGTGAGA	L:T:CD8:EM
CAAAGAAGTCCCGGTA	L:T:CD4:EM
CACAACATCGTGGGTC	L:T:CD4:Naive
CACGTGGCAGATCATC	L:T:CD8:CM
CACTGGGTCTTGATTC	L:T:CD4:CM
CAGCCAGAGACAGTCG	L:T:CD4:Naive
CATACAGAGTCTCTGA	L:T:CD4:Naive
CATCGCTAGCGTTGTT	L:T:CD4:Naive
CATGCAAAGCATCCTA	L:T:CD4:CM
CATGCTCGTCGATTAC	L:T:CD4:CM
CCCTCTCCAAATGATG	L:T:CD4:CM
CCGGTAGCAAGCTGCC	L:T:CD4:Naive
CCTCCTCGTCGACTGC	L:T:CD8:EMRA
CCTGTTGAGGCCACTC	L:T:CD4:EM
CGAGAAGGTATGTGTC	L:T:CD8:EM
CGCATGGCAGCGACCT	L:T:CD4:Naive
CGTAAGTAGTACCGGA	L:T:CD4:EM
CGTAGTAAGTGAACAT	L:T:CD8:EMRA
CTCAATTAGGAGGTTC	L:T:CD8:EM
CTGAATGCATCTCAAG	L:T:CD4:CM
CTTCAATAGAGCGACT	L:T:CD8:EMRA
CTTCAATTCAGAGCAG	L:NK
GACAGCCAGCAATTAG	L:T:CD4:CM
GACATCACAGATTAAG	L:T:CD4:CM
GACCTTCCACGACAGA	L:T:CD4:Naive
GACTCTCCATCCGTTC	L:T:CD4:EM
GACTTCCCAAGACAAT	L:T:CD4:Naive
GAGCCTGAGTGATTCC	L:T:CD4:CM
GATCAGTTCTGCGAGC	L:T:CD8:EMRA
GATGATCTCTCTCGCA	L:T:CD8:Naive
GATTCTTGTCTGTTAG	L:T:CD8:Naive
GCACATACAGTTGCGC	L:T:CD4:CM
GCACGGTCAAGGCCTC	L:T:CD4:CM
GCAGCCACAAGCGATG	L:T:CD4:CM
GCAGTTATCCAGTACA	L:T:CD8:EMRA
GCATCGGGTAGTAAGT	L:NK
GCATCGGTCGCTTGAA	L:T:CD4:CM
GCCCAGAGTGTCGCTG	L:T:CD4:EM
GCTACAATCAGCGCAC	L:T:CD4:Naive
GGTCTGGGTCGATTCA	L:T:CD8:EMRA
GTAGGAGTCTTCGGAA	L:T:CD4:CM
GTAGTACGTTTAGACC	L:T:CD4:Naive
GTATTGGTCCGATTAG	L:T:CD4:Naive
GTCACTCAGACTTAAG	L:T:CD4:Naive
GTCATCCGTCTTAGTG	L:B:PC
GTGCTTCCAGTCTCTC	L:T:CD4:Naive
GTGCTTCCATCCAATG	L:T:CD4:EM
GTGGAAGGTCGCCACA	L:T:CD4:CM
GTGGAAGGTGTCGCTG	L:T:CD4:Naive
GTTGCTCGTTAAGTCC	L:T:CD4:Naive
GTTGTAGAGTCACAGG	L:T:CD4:Naive
GTTGTCCCACACTGGC	L:T:CD4:CM
TAACGACGTTCTCAGA	L:T:CD8:Naive
TACCGGGAGTGCACCC	L:T:CD4:CM
TACCTGCTCGCAGTGC	L:T:CD4:Naive
TACTTACTCAAGCTTG	L:T:CD4:Naive
TAGCACACATGGAACG	CD34
TCAAGACCACAACGCC	L:T:CD8:EMRA
TCACAAGAGATTGTGA	L:T:CD8:EMRA
TCACTATAGGTTAAAC	L:T:CD4:Naive
TCATACTGTTGGACCC	L:T:CD4:CM
TCCACGTTCGTCGACG	L:T:CD8:EMRA
TCCATGCGTACTGCGC	L:T:CD8:CM
TCCTCCCGTTAAGACA	L:T:CD4:EM
TCGAAGTTCGCTCCTA	L:T:CD4:Naive
TCTACCGAGTACCCTA	L:T:CD8:EMRA
TCTACCGAGTTACTCG	L:T:CD4:Naive
TCTGTCGGTCCTGTTC	L:T:CD8:EMRA
TGAATGCTCGTAGGAG	L:T:CD4:CM
TGAGCATCAATGAAAC	L:T:CD4:Naive
TGAGGGAGTAGGGAGG	L:T:CD4:CM
TGCTCGTCAAGGCTTT	L:T:CD8:EMRA
TGGTACAAGTGCGCTC	L:T:CD4:Naive
TGGTTAGCACTATGTG	L:T:CD4:CM
TGTAACGAGTCTACCA	L:B:PC
TGTCCCAAGTCGAAAT	L:T:CD4:Naive
TGTCCTGAGGCCTGAA	L:T:CD4:Naive
TGTGATGGTTACACAC	L:T:CD8:Naive
TGTGGCGGTTTCCCAC	L:T:CD4:CM
TTCCACGTCTGCGATA	L:T:CD4:Naive
TTCCGTGCACGCGGTT	L:T:CD8:CM
TTCCTTCGTCTTAGTG	L:T:CD4:CM
TTCTCTCGTCACATTG	L:T:CD4:EM
TTCTTCCCATCAACCA	L:T:CD4:CM
TTGAACGTCAATCGGT	L:T:CD4:CM
TTGTTTGCAATGGCCC	L:T:CD4:EM
TTTCCTCTCAGTGCGC	L:T:CD4:CM
AAAGAACGTACGACAG	L:T:CD4:Naive
AACCAACGTTTGGGTT	L:T:CD4:CM
ACAACCACAACGGTAG	L:T:CD8:EMRA
ACGATGTCAGCCTACG	L:T:CD8:EMRA
ACTCCCAAGTCGGGAT	L:T:CD8:EM
ACTGATGGTCCTGTCT	L:T:CD8:Naive
ACTGTCCCATAGTCGT	L:T:CD8:EMRA
AGAACCTTCCCTCGAT	L:T:CD4:CM
AGACCATCATCTATCT	L:T:CD8:EMRA
AGATCGTAGGAATCGC	L:T:CD8:EMRA
AGCGCTGCAACCAGAG	L:T:CD8:Naive
AGCGTATCAGGCACAA	L:T:CD4:CM
AGCTCAAAGTTTGGCT	L:T:CD4:Naive
AGGGTCCGTAGTAAGT	L:T:CD8:EMRA
AGTAACCTCATTCTTG	L:T:CD8:Naive
AGTCATGGTGCAGGAT	L:T:CD8:Naive
AGTCTCCTCGTCAACA	L:T:CD8:EMRA
AGTTCCCCACCATTCC	L:T:CD8:CM
ATCCATTAGCTCTTCC	L:T:CD8:EMRA
ATGACCAGTCAGGAGT	L:T:CD4:CM
CAACGATTCACCGGTG	L:NK
CAACGGCGTGATACCT	L:NK
CACCAAAAGCCGAACA	L:T:CD4:CM
CACTAAGCACCCTGTT	L:T:CD8:Naive
CACTGGGGTACAGAGC	L:T:CD8:EM
CAGAGCCCATTCAGCA	L:T:CD4:CM
CATACCCCAATCAGCT	L:T:CD8:Naive
CATACCCCAGAGTGTG	L:T:CD4:CM
CATGCAAGTTTCCCAC	L:T:CD4:Naive
CATGCTCAGTCCGCGT	L:B:PC
CATTGCCTCGATGCAT	L:T:CD4:CM
CCAAGCGCAGTCAGCC	L:T:CD8:Naive
CCAATTTTCCGCACGA	L:T:CD8:EMRA
CCACCATAGTTGCTGT	L:T:CD8:EMRA
CCCGGAATCAGACCCG	L:T:CD4:Naive
CCGGACACAACGTATC	L:T:CD4:CM
CCGGGTATCCTTCACG	L:NK
CCTCCTCAGAGCAGCT	L:T:CD4:CM
CCTCTCCAGCTCAGAG	L:T:CD8:EMRA
CCTGTTGGTCGTAATC	L:T:CD8:EMRA
CCTTCAGGTCACAATC	L:T:CD4:Naive
CGAAGGACATTAGGAA	L:T:CD8:EMRA
CGATGCGAGAGTTGCG	L:T:CD4:Naive
CGCAGGTAGTCGAATA	L:T:CD4:CM
CGCCATTTCAAAGAAC	L:T:CD4:Naive
CGGAGAAGTGGAACCA	L:T:CD8:EMRA
CGGCAGTTCTATACTC	L:T:CD4:CM
CGTAAGTTCCTGTTGC	L:NK
CGTGATATCCTACAAG	L:NK
CTACATTGTGTGTACT	L:T:CD4:CM
CTACCTGTCGTGGAAG	L:T:CD8:EMRA
CTACTATGTGAGGAAA	L:T:CD4:Naive
CTCAACCAGACGCTCC	L:T:CD4:Tfh
CTCCCAAGTACCAATC	L:T:CD8:EMRA
CTCCCTCCACAGCCAC	L:T:CD4:CM
CTCCTTTAGATAACGT	L:T:CD8:EMRA
CTCGAGGCATACTGAC	L:T:CD4:Naive
CTGCAGGTCCACACCT	L:T:CD8:Naive
CTGCGAGAGGAGTACC	L:T:CD4:CM
CTGTGGGAGTCCCGAC	L:T:CD4:CM
GAACTGTTCGTCAGAT	L:T:CD4:Naive
GACCGTGCACAAGCTT	L:T:CD4:CM
GACCTTCCAGAACGCA	L:T:CD8:EMRA
GACGTTAGTTTGACAC	L:T:CD4:CM
GAGCTGCCAGTGAGCA	L:T:CD4:CM
GAGGCAAGTACGGTTT	L:T:CD4:CM
GAGGGATTCCTCTCGA	L:NK
GATCACAAGCTTCGTA	L:T:CD4:Naive
GATGACTCAAAGGCGT	L:T:CD8:EMRA
GCAACATCACCCAACG	L:T:CD8:EMRA
GCACGTGTCCTATTGT	L:T:CD4:CM
GCAGCTGAGTCATAGA	L:T:CD8:EMRA
GCAGGCTCATGCACTA	L:T:CD8:Naive
GCAGGCTGTGCCCAGT	L:T:CD8:EM
GCATCTCAGCTATCTG	L:T:CD4:EM
GCTGAATCACTGTGAT	L:T:CD4:CM
GCTGGGTGTTTGAAAG	L:T:CD8:EMRA
GGAATGGAGCATGCGA	L:T:CD4:CM
GGAGATGGTTTACGTG	L:T:CD8:EMRA
GGAGATGTCCGTGGGT	L:T:CD8:EMRA
GGGATCCAGTGCGACA	L:T:CD4:Naive
GGTGTTAGTTGACTGT	L:T:CD4:Naive
GTAATCGAGTGGATTA	L:T:CD4:Naive
GTCATCCCATTCCTAT	L:T:CD4:Naive
GTCATGAAGCCTCTTC	L:T:CD8:EMRA
GTCTCACCAGCATTGT	L:T:CD4:CM
GTGCACGGTGTAACGG	L:T:CD4:CM
GTGGAAGTCTATTTCG	L:T:CD8:CM
GTGGAAGTCTGAGAGG	L:T:CD4:CM
GTGGTTAGTTGGGCCT	L:T:CD4:CM
GTGTCCTCATTGAGCT	L:T:CD4:Naive
GTGTTCCGTCGCACGT	L:T:CD4:Naive
GTTGTCCGTTTGTGGT	L:T:CD4:Naive
GTTGTGACACGAGAAC	L:T:CD8:EMRA
TAAGCACTCCGATCGG	L:unconvT:gdT
TAAGTCGCAATCCAGT	L:NK
TACATTCGTGCGTTTA	L:T:CD8:EM
TAGAGTCGTCTGATCA	L:T:CD8:EMRA
TAGATCGGTGAGAACC	L:T:CD8:Naive
TAGGGTTGTTCCGCTT	L:T:CD8:EMRA
TATTGGGTCGTGCACG	L:T:CD8:EMRA
TCAGGGCAGTGGTCAG	L:T:CD8:EMRA
TCATACTGTAGGGAGG	L:T:CD4:Naive
TCATTCAGTAGGTAGC	L:B:PC
TCCATGCGTAGGACCA	L:T:CD4:CM
TCCATGCTCTTGGGCG	L:T:CD4:CM
TCCTCGACACGGGCTT	L:T:CD4:Naive
TCCTGCAAGCCTCTCT	L:T:CD4:Naive
TCGCACTAGGAATGTT	L:T:CD8:Naive
TCTAACTAGCAGCCTC	L:T:CD8:Naive
TCTTCCTTCGTCTCAC	L:T:CD4:EM
TGAATCGAGTCGAGGT	L:T:CD8:EMRA
TGAATGCAGGAGGTTC	L:T:CD8:Naive
TGACTCCAGATGGCAC	L:T:CD8:CM
TGACTCCAGGCGATAC	L:T:CD4:Naive
TGAGACTGTCGGCACT	L:T:CD8:EMRA
TGATTCTCAAGACGAC	L:T:CD4:CM
TGCGGCACACTACACA	L:T:CD8:EMRA
TGGAGGAGTTGAGAGC	L:T:CD8:EMRA
TGGGCTGTCTTGTTAC	L:T:CD4:Naive
TGTCAGAGTTACGATC	L:T:CD4:Naive
TTCACGCTCAGGAGAC	L:T:CD4:CM
TTCCGGTAGTCCGCGT	L:T:CD8:Naive
TTCCGTGAGTCCTGCG	L:T:CD4:Naive
TTGACCCGTTCATCTT	L:B:PC
TTGATGGAGGTGGTTG	L:T:CD4:CM
TTGGGTAAGGTTCCGC	L:T:CD4:Naive
TTGGTTTCAGTTGAAA	L:T:CD4:CM
TTGTTGTTCGGAATGG	L:T:CD4:Naive
TTTCACAGTAAGGAGA	L:B
TTTCATGCAGGCTATT	L:T:CD4:Naive
AACAAAGCAGCCTATA	L:T:CD4:CM
AACAGGGCATTATGCG	L:T:CD8:EMRA
AACCATGCACGACAGA	L:T:CD4:CM
AATAGAGGTTGCGGAA	L:T:CD8:EMRA
AATTCCTGTTGTGCCG	L:T:CD4:CM
ACAAGCTCAGACGCTC	L:T:CD4:CM
ACAGCCGTCCATAGGT	L:T:CD4:Naive
ACGTACACAGGAAGTC	L:T:CD4:CM
ACGTAGTCATTCATCT	L:T:CD8:EM
ACTCCCACACTTCAGA	L:T:CD4:Naive
AGAACCTTCACCCATC	L:T:CD4:CM
AGACTCAAGCGTGAAC	L:T:CD8:Naive
AGGAAATCAAGAGTTA	L:T:CD8:EMRA
AGGATAATCTGGAAGG	L:T:CD4:CM
AGGCATTAGTGATAAC	L:T:CD4:Naive
AGGGAGTTCGATTCCC	L:T:CD4:EM
AGGGCCTAGCCGTAAG	L:B:PC
AGGTGTTCATGACTAC	L:T:CD4:Naive
AGTAGTCTCAAACGAA	L:T:CD8:Naive
AGTCATGGTAGAGACC	L:T:CD8:EMRA
ATCCGTCTCAGCTCTC	L:T:CD4:CM
ATGAGTCTCGCAGAGA	L:T:CD8:EMRA
ATGGGAGGTTGCCGAC	L:T:CD4:CM
ATTCCCGTCTCTGAGA	L:T:CD4:Naive
ATTTCTGAGACGCAGT	L:T:CD4:CM
ATTTCTGTCAATCCAG	L:T:CD8:EMRA
CAAGGGAGTCGAATTC	L:T:CD4:CM
CACAGATAGTGGTCAG	L:T:CD4:CM
CACTAAGAGGACATCG	L:T:CD8:EMRA
CACTTCGAGCTTCGTA	L:T:CD4:Naive
CATAAGCTCTTCGCTG	L:T:CD8:EMRA
CCGATGGGTTAGAGTA	L:T:CD4:Naive
CCGGGTATCTTAGCTT	L:T:CD4:CM
CCTCAACGTTATGGTC	L:T:CD4:CM
CCTCATGCAAAGGATT	L:T:CD4:Naive
CCTCTAGCAGATTCGT	L:T:CD4:CM
CCTCTCCCAGAACGCA	L:T:CD8:Naive
CCTGCATTCTGTTGGA	L:T:CD4:Naive
CCTTTGGTCCTGGCTT	L:B:PC
CGAATTGCAGTATGAA	CD34
CGCAGGTCATGGCCCA	M:Mega
CGGAATTCAGACAAAT	L:T:CD4:CM
CGTAATGTCGAGAGAC	L:T:CD4:Naive
CGTAGTACAGGTTCGC	L:T:CD8:Naive
CGTCCATCAATAGGGC	L:T:CD4:Naive
CGTTGGGCACTACAGT	L:NK
CTAGGTAGTTATGTCG	L:B:PC
CTATAGGTCTTAATCC	L:T:CD4:EM
CTATCCGAGAACAAGG	L:T:CD4:EM
CTCCACACAAATGCTC	L:T:CD4:EM
CTCCTCCTCGTTGTTT	L:T:CD4:CM
CTCTCGAGTCCCTGTT	L:T:CD4:Naive
CTGCCTATCTCGCCTA	L:T:CD4:Naive
CTTCTAAAGGTACAGC	L:T:CD4:CM
GAAGTAACACACAGCC	L:T:CD4:EM
GACCCTTAGTCGCGAA	L:T:CD4:CM
GACTTCCGTGAGTTTC	L:T:CD4:CM
GAGTGTTCATGAATAG	L:T:CD8:EMRA
GATTGGTGTGTCCTAA	L:T:CD4:Naive
GCACGGTCATGGCACC	L:NK
GCACGTGGTCCACACG	L:T:CD4:Naive
GCAGCTGCATGAGAAT	L:T:CD8:EMRA
GCCCGAAAGCATATGA	L:T:CD4:Naive
GCGGATCAGGTAACTA	L:T:CD8:CM
GCGGATCGTGCGGATA	L:T:CD4:Naive
GCGTGCACAACCGATT	L:T:CD4:CM
GCTGGGTGTCATACCA	L:T:CD8:EMRA
GGAACCCTCGGCCCAA	L:T:CD4:CM
GGATCTATCCTGGGAC	L:T:CD4:Naive
GGGCGTTAGGCTCTCG	L:T:CD8:EM
GGTGATTAGTAAGCAT	L:T:CD8:EMRA
GGTGGCTCAGTGGTGA	L:B:PC
GTAACCAAGAGGTCAC	L:T:CD8:EMRA
GTCATCCCACAGCTTA	L:T:CD4:CM
GTCTGTCAGGATTCCT	L:NK
GTCTTTACACACCGCA	L:T:CD4:CM
GTCTTTAGTAGGCAAC	L:T:CD4:CM
GTCTTTATCATGCCCT	L:T:CD4:Naive
GTGCGTGGTGATAGTA	L:T:CD8:EMRA
GTGCTGGGTAGGAAAG	L:T:CD4:CM
GTGGAGAGTGTTTACG	L:T:CD4:Naive
GTGGAGAGTTGTGTAC	L:NK
GTTTACTTCATTGGTG	L:T:CD4:Naive
TAAGCACGTTTACGTG	L:T:CD8:EMRA
TAAGCCAGTGATCGTT	L:T:CD4:Naive
TAATTCCTCACCTGTC	L:T:CD4:Naive
TACGCTCTCGGTCAGC	L:T:CD4:CM
TACGGGCCAGCTCGGT	L:T:CD8:EMRA
TCAAGCATCTTACGGA	L:T:CD4:Naive
TCACATTCAACAACAA	L:T:CD4:CM
TCACGGGGTATCCCTC	L:T:CD4:Naive
TCAGCAACACACCTAA	L:T:CD8:EM
TCATGGAGTGAGATTA	L:T:CD4:CM
TCATTCATCCTGGTCT	L:T:CD4:Naive
TCCATCGAGCAAATCA	L:T:CD4:CM
TCCCACACATAATGAG	L:T:CD4:CM
TCCTCGAAGGCACTAG	L:T:CD4:CM
TCTAACTTCCCGTGTT	L:T:CD4:CM
TCTTGCGCATAGAATG	L:T:CD8:EMRA
TGAACGTTCGCTCTCA	L:T:CD4:Naive
TGAGCGCAGGTAGGCT	L:T:CD4:CM
TGAGGGAAGAACAAGG	L:T:CD4:Naive
TGATCTTAGGACTTCT	L:T:CD4:CM
TGATTTCGTCTTACTT	L:T:CD4:CM
TGCTGAACATCATCTT	L:B:PC
TGGGAAGAGGATTTAG	L:T:CD4:CM
TGGGAGACACTGTCGG	L:T:CD8:EMRA
TGTAACGCATCATCTT	L:T:CD4:EM
TGTCAGACATCCGAAT	L:T:CD4:CM
TGTCCACTCGATTGGT	L:T:CD8:EMRA
TGTCCTGAGTGGCAGT	L:T:CD4:EM
TGTGATGGTTACACTG	L:T:CD4:Naive
TGTGCGGAGATCGCCC	CD34
TGTTGGAGTCGTATGT	L:T:CD8:EM
TTACAGGAGTTGCATC	L:T:CD4:CM
TTAGGGTTCATGACAC	L:T:CD4:CM
TTCCTCTTCCGAAATC	L:T:CD8:EMRA
TTCTGTAGTGACCTGC	L:NK
TTGAGTGAGTTGCTCA	L:T:CD8:EMRA
TTGGTTTCATAACAGA	L:T:CD4:EM
TTGTTCATCCACATAG	L:T:CD4:CM
TTTCCTCTCTAAGCCA	L:T:CD8:EMRA
TTTGACTCACCCTAGG	L:T:CD4:Naive
TTTGGAGTCTCCATAT	L:T:CD4:Naive
AACCCAAAGGGAGAAT	L:T:CD8:EMRA
AACGGGACACAAATCC	L:T:CD4:Tfh
AAGACAATCAAAGGAT	L:T:CD8:CM
AAGCATCAGTCTGCAT	L:T:CD8:Naive
AATCACGTCGCTCCTA	L:T:CD4:Naive
AATGGAAGTTGCCGAC	L:T:CD8:EMRA
ACAGAAAAGAGTATAC	L:T:CD4:CM
ACCCTCAAGCGTATAA	L:T:CD8:EMRA
ACCTGAAAGTATCCTG	L:T:CD4:CM
ACGGTCGAGTTCACTG	L:T:CD8:EMRA
ACGGTTAAGCCAAGGT	L:T:CD4:Naive
ACTTCGCCACTGAGTT	L:T:CD4:CM
AGAACAAGTCGAGTTT	L:T:CD4:CM
AGAAGCGGTGAGACGT	L:T:CD4:CM
AGAGAATGTCGATTCA	L:T:CD8:Naive
AGATGAAAGAAGCCAC	L:T:CD4:Naive
AGCCACGTCCCAGTGG	L:T:CD4:CM
AGCTTCCCACCAGTTA	L:T:CD4:CM
AGTCACAAGCGATTCT	L:T:CD4:EM
AGTGCCGCACGTACTA	L:T:CD4:CM
AGTGTTGAGCCTGCCA	L:T:CD8:EMRA
ATCAGGTGTGTGTGGA	L:T:CD8:Naive
ATCGTCCGTCTCGGAC	L:B:PC
ATCGTCCGTTGACGGA	L:T:CD4:CM
ATGCCTCTCCCGAACG	L:T:CD4:EM
ATGGGAGTCTGCTTAT	L:T:CD4:Naive
ATTACTCTCCTAACAG	M:pDC
ATTCAGGCATAGACTC	L:T:CD8:EM
CAATCGACACGAGAAC	L:T:CD4:Naive
CACTAAGAGTGCGCTC	L:T:CD4:CM
CAGTTCCAGGTAAACT	L:T:CD4:CM
CAGTTCCCACTCATAG	L:T:CD4:Naive
CATGGATTCATCACCC	L:T:CD4:CM
CCAATTTGTGGTCTTA	L:T:CD4:Naive
CCTCAACCAGTTCCAA	L:T:CD4:EM
CCTTTGGAGGCTTTCA	L:T:CD4:CM
CGAAGTTGTAACAGTA	L:T:CD4:Naive
CGACAGCGTTTCCATT	L:T:CD4:CM
CGATGCGGTTCCAGGC	L:T:CD4:Naive
CTATCCGCAACATCGT	L:T:CD4:CM
CTCAGAAAGCATATGA	L:T:CD8:EM
CTGTATTCATATGCGT	L:T:CD8:EMRA
GAAATGAGTGTAGTGG	L:NK
GAAGCGAAGACAACAT	L:T:CD4:Naive
GAGATGGCAGAGGCAT	L:T:CD8:EM
GAGCTGCCACATAGCT	L:NK
GAGTCTAGTCGTGATT	L:T:CD8:EMRA
GATGACTTCATCTGTT	L:T:CD8:EMRA
GCATGATCAACGGCTC	L:T:CD4:Naive
GCGATCGTCCGACATA	L:T:CD8:EMRA
GCGGAAAGTAGCTGTT	L:T:CD4:Naive
GCGGATCCAGGACAGT	L:T:CD8:EMRA
GGCTTGGCAGAGGAAA	L:T:CD4:Naive
GGGCCATAGGCATGGT	L:T:CD4:Naive
GGGCCATGTCTAACGT	L:T:CD4:CM
GGGTATTCATTCTCTA	L:T:CD4:Naive
GGTGTTACATAATGCC	L:T:CD4:Naive
GGTGTTAGTATGAAGT	L:T:CD4:CM
GGTGTTATCAGAGCAG	L:T:CD4:Naive
GTCATTTTCGTCAACA	L:NK
GTGACGCGTTTGGCTA	L:T:CD8:EMRA
GTGCACGAGCCGATCC	L:T:CD8:EMRA
GTTCCGTAGCCGGATA	L:T:CD4:EM
GTTGTAGAGTGGTTCT	L:T:CD4:CM
GTTGTCCGTGGACTAG	L:T:CD8:Naive
TAATCTCTCACTGGTA	L:B:PC
TACCTGCTCGCTTGCT	L:T:CD4:CM
TACTTCAAGGTGCTTT	L:T:CD4:CM
TATATCCGTGTGCTTA	L:T:CD4:Naive
TATTCCATCCTACCAC	L:T:CD4:Naive
TCAAGTGTCCAAGGGA	L:T:CD8:EM
TCAAGTGTCTTACGGA	L:T:CD8:EMRA
TCAGTCCTCTACACTT	L:T:CD4:EM
TCAGTGACATATCGGT	L:T:CD8:EMRA
TCATACTGTCGATGCC	L:T:CD4:Naive
TCATTTGAGCTGCGAA	L:T:CD4:Naive
TCCCAGTTCGCTGCGA	L:T:CD4:Naive
TCGAAGTAGGATTCAA	L:T:CD8:EMRA
TCTATACGTATACAGA	L:T:CD8:EM
TGAACGTGTTGCAAGG	L:T:CD4:CM
TGACTCCCATCGAACT	L:T:CD4:Naive
TGAGCATGTAAGTTAG	L:T:CD8:Naive
TGCAGGCTCGTAGGGA	L:T:CD4:CM
TGCATCCAGCATACTC	L:T:CD8:EMRA
TGCGACGCATTGAGGG	L:T:CD4:Naive
TGCGATAAGTTGTAAG	L:B:PC
TGGGAGAAGATGCTAA	L:T:CD8:EMRA
TGGGAGACATAGGCGA	L:NK
TGGTGATAGCGAATGC	L:T:CD4:Naive
TGTCCACTCATAGCAC	L:T:CD8:EMRA
TGTGTGATCACTACGA	L:T:CD8:Naive
TTAGTCTTCACCTGTC	L:T:CD4:CM
TTCATGTGTCAGTTTG	L:T:CD4:CM
TTCATGTTCGTGCGAC	L:NK
TTCGGTCAGACCAAGC	L:T:CD8:CM
TTCTAACGTAACGATA	L:T:CD4:CM
TTCTAGTGTCCCGGTA	L:T:CD4:CM
TTCTTGATCGGTCTGG	L:T:CD4:CM
TTGCATTAGTGCACCC	L:T:CD4:Naive
TTGTGTTCACCCAAGC	L:T:CD4:EM
TTTGATCCATCCTATT	L:T:CD4:Naive
TTTGGAGGTCTAGATC	L:T:CD4:CM
AAAGGTAGTAATGCTC	L:T:CD8:EMRA
AACAACCCACATACTG	L:T:CD4:EM
AACTTCTCATCCGGTG	L:T:CD4:CM
AAGCGAGCATATTCGG	L:T:CD8:EMRA
AAGCGTTAGTTCCGGC	L:T:CD4:Naive
AAGGAATGTCGAATGG	L:T:CD4:Naive
AATAGAGTCAGCATTG	L:T:CD4:CM
AATGACCGTAGACTGG	L:T:CD4:Naive
AATGGAAGTCGAGCAA	L:T:CD4:Naive
ACACTGATCCGGTAAT	L:T:CD4:CM
ACATTTCCAAATGAAC	L:T:CD4:CM
ACCCAAACATCCTTGC	L:T:CD4:Naive
ACGTCCTCACAAATAG	L:T:CD4:Naive
ACTGTGATCCGGTAAT	L:T:CD4:CM
AGAGAATCAACCACGC	L:T:CD4:Naive
AGCGCTGCAAGTCGTT	L:T:CD4:Naive
AGGTTGTGTGCTGATT	L:T:CD8:EMRA
AGTACCAAGCTGGAGT	L:T:CD8:EMRA
AGTCAACAGATTGAGT	L:T:CD8:EMRA
AGTGCCGAGCGCTGCT	L:NK
ATATCCTGTTAGAAAC	L:T:CD8:EMRA
ATCCCTGGTGGGAGAG	L:NK
ATCGTCCTCCTACGGG	L:T:CD8:EMRA
ATGCGATAGGTTACCT	L:T:CD4:Naive
ATGGGTTTCCGGACGT	L:B:PC
ATGTCTTCAAGACGGT	L:T:CD4:Naive
ATTCGTTTCTCAACCC	L:T:CD4:Naive
ATTTCTGCAGCGGATA	L:T:CD4:EM
CAACCTCAGACATATG	L:T:CD4:Naive
CAAGCTACACAAGCCC	L:T:CD4:EM
CAATGACGTGGCAACA	L:T:CD4:Naive
CACAACAAGGGAGGGT	L:T:CD4:Naive
CACATGAGTCGAGTTT	L:T:CD8:EMRA
CACGAATGTGTAAACA	L:T:CD8:EMRA
CACTAAGTCTGCCTCA	L:T:CD8:EMRA
CACTTCGTCCATCTGC	L:T:CD8:EM
CAGATACTCGTCTACC	L:B:PC
CATCCCATCCATCTAT	L:T:CD4:Tfh
CATCGGGGTTTACTTC	L:T:CD4:CM
CATGAGTTCTTTACAC	L:T:CD4:CM
CATGGTAGTGAGGCAT	L:T:CD4:EM
CCCTCAAGTAACGCGA	L:T:CD4:CM
CCTCAACGTCAAACGG	L:T:CD8:EMRA
CCTCACAGTCATGACT	L:T:CD4:EM
CCTTGTGCATGACACT	L:T:CD4:Naive
CGCGTGAGTAACGCGA	L:T:CD8:EMRA
CGGAGAAGTCTCCCTA	L:T:CD8:EM
CGTTAGATCAATCTTC	L:T:CD8:Naive
CTACAGAGTTACAGCT	L:T:CD4:Naive
CTCATTATCCACCTGT	L:T:CD4:CM
CTCTCAGGTCCGATCG	L:T:CD8:EMRA
CTGATCCCATCGCTGG	L:T:CD4:CM
CTGGACGGTAGATTAG	L:T:CD8:Naive
GAAGAATGTCATCCGG	L:T:CD8:EMRA
GAAGCGAAGATTGCGG	L:T:CD4:CM
GAAGGGTAGCGAGAAA	L:T:CD4:Naive
GAAGTAAGTCTCACGG	L:T:CD8:EM
GACCTTCCATCGGATT	L:B:PC
GAGACTTAGTTACGTC	L:T:CD8:EMRA
GAGATGGCATACCACA	L:T:CD4:CM
GAGTCTAAGATGACAT	L:T:CD8:EMRA
GAGTTTGTCATCTGTT	L:T:CD8:EMRA
GAGTTTGTCCTGGTCT	L:B:PC
GATCGTAGTTGGTAGG	L:T:CD8:EMRA
GATGAGGAGCCGGATA	L:T:CD4:CM
GCAGGCTAGGGAGAAT	L:T:CD4:CM
GCATCTCTCGTGGGAA	L:T:CD8:EMRA
GCATTAGCATGGGATG	L:T:CD4:CM
GCCAGCAGTTGCAACT	L:T:CD4:CM
GCCATGGGTGCCTGAC	L:T:CD8:Naive
GGAGAACGTTGGGCCT	L:T:CD8:EMRA
GGAGCAAGTTGCTGAT	L:T:CD8:EMRA
GGGACAAGTCATCCGG	L:T:CD4:CM
GGGACCTAGCCTGTGC	L:T:CD4:CM
GGGACTCTCCGCACGA	L:B:PC
GGGATGAAGCTCATAC	L:T:CD8:EMRA
GGGCTACTCTTACGGA	L:T:CD4:CM
GGGTATTTCGTGGCGT	L:T:CD8:CM
GGTAGAGCAATGAAAC	L:T:CD4:CM
GGTCTGGTCAAGGACG	L:T:CD4:CM
GGTGGCTCATGGTGGA	L:T:CD8:EM
GTAATGCTCACGTAGT	L:T:CD8:EMRA
GTAGCTAGTCCATACA	L:T:CD8:Naive
GTCAAACTCCTTGGAA	L:NK
GTCAAGTTCTTGCGCT	L:B:PC
GTTACGAAGATCACCT	L:T:CD4:Naive
GTTAGTGGTGCGGTAA	L:T:CD4:Naive
GTTCGCTGTACTGCGC	L:T:CD4:EM
GTTGTCCCAAAGGGTC	L:B:PC
TAACCAGAGTGAGGCT	L:T:CD4:Naive
TAACCAGGTAGTCTTG	L:T:CD4:Naive
TATCCTAGTGTGTGGA	L:T:CD4:Naive
TATTGGGAGTCTAACC	L:NK
TATTGGGGTTACACTG	L:T:CD4:CM
TCAAGTGGTGGGTTGA	L:T:CD8:EMRA
TCAATCTTCTAGTGTG	L:T:CD4:CM
TCAATCTTCTCCACTG	L:T:CD4:CM
TCAATTCAGCGTCTGC	L:NK
TCAATTCCAACCGCTG	L:T:CD4:EM
TCACTATTCGTTTACT	L:T:CD4:CM
TCACTCGTCGCAAGAG	L:T:CD4:CM
TCAGCCTAGCTTGTTG	L:T:CD4:Naive
TCAGGGCGTACAGGTG	L:T:CD4:CM
TCATCATGTGCTTCAA	L:T:CD4:EM
TCATGCCAGCAGGCAT	L:T:CD4:Naive
TCCTTCTAGTTTCAGC	L:T:CD8:EMRA
TCTATACGTGGCAGAT	L:T:CD4:CM
TCTCACGAGTATCTGC	L:T:CD8:EMRA
TGAGGAGTCATTGTGG	L:T:CD8:EMRA
TGCGGCACAGTGGGTA	L:T:CD4:EM
TGCTTCGAGGGAGTTC	L:T:CD4:CM
TGGAGGAGTTTACTGG	L:T:CD8:EMRA
TGTCAGAGTCGAGCTC	L:T:CD4:Naive
TGTCCACAGTATAGAC	L:T:CD8:EM
TGTGATGCAAGTGATA	L:T:CD8:Naive
TGTGGCGCAATCGCAT	L:T:CD4:CM
TGTTGAGCACTTGACA	L:T:CD4:CM
TTACCGCGTGTCCATA	L:T:CD4:CM
TTACGCCCAATCTCTT	L:T:CD8:Naive
TTAGGGTAGGCGACAT	L:T:CD8:Naive
TTCTTCCCAACGACAG	L:T:CD8:EMRA
TTGCATTAGTCTTGGT	L:T:CD8:EMRA
TTGGATGAGGTCATTC	L:T:CD4:Naive
TTGTGTTAGTCATGAA	L:T:CD4:Naive
TTGTTGTCAGCGTTTA	L:T:CD4:Naive
TTTACGTGTACGTGAG	L:T:CD8:EM
AACAAAGGTCCCGTGA	L:T:CD4:CM
AACACACGTGCGAACA	L:T:CD8:EMRA
AACGAAAAGTCACTGT	L:T:CD4:Naive
AACGTCAAGTAGCAAT	L:NK
AATAGAGGTCACGTGC	L:T:CD4:CM
AATCACGGTCCACACG	L:T:CD4:Naive
AATTCCTGTTATTCTC	L:T:CD4:Naive
ACACAGTCATCGTCCT	L:T:CD8:EMRA
ACAGAAAAGTTCCTGA	L:T:CD4:CM
ACATGCAAGAAGAACG	L:T:CD8:EMRA
ACGCACGCAGGTGACA	L:T:CD4:CM
ACTATGGTCACAAGGG	L:T:CD8:EMRA
ACTCCCATCGATCCAA	L:T:CD8:EMRA
AGACTCATCAGAGCAG	L:T:CD8:EMRA
AGAGAATTCCGCACTT	L:T:CD8:EMRA
AGCCAATTCTATGTGG	L:T:CD8:EMRA
AGGGTGAAGGTACATA	L:T:CD4:Naive
AGTACCAAGTCGGCCT	L:T:CD4:Naive
AGTACTGAGCTAATGA	L:T:CD4:Naive
AGTCATGTCTGGGTCG	L:T:CD8:Naive
AGTGACTGTTGTTGCA	L:T:CD4:CM
ATAGGCTAGCACCAGA	L:T:CD4:CM
ATAGGCTAGTCAGGGT	L:T:CD8:EMRA
ATCAGGTCACAATGTC	L:T:CD4:Naive
ATCGATGCACTGCATA	L:T:CD4:CM
ATCGGCGGTCGGCCTA	L:T:CD4:CM
ATGGGTTTCAGGTAAA	L:T:CD8:EMRA
ATGGGTTTCTTCCACG	L:NK
ATTCCATCAAGACAAT	L:T:CD4:CM
ATTCGTTTCCTACTGC	L:T:CD8:EM
CAACGATGTTATTCCT	L:T:CD4:Naive
CAACGGCAGAAGGATG	L:T:CD8:EMRA
CAAGGGACACCCTGAG	L:T:CD4:CM
CAATCGAGTATAATGG	L:T:CD8:EM
CACAGATAGCGTGAAC	L:T:CD8:EMRA
CACTTCGTCAGCCTTC	L:T:CD8:CM
CAGATTGGTACTCGTA	L:T:CD4:CM
CAGCAATCAGTGTATC	L:T:CD8:EMRA
CAGCCAGCAAATCGTC	L:T:CD4:CM
CAGGCCACACTTGGGC	L:T:CD4:Naive
CAGGGCTAGTCTGCAT	L:T:CD4:Naive
CAGGTATAGGTATTGA	L:T:CD4:Naive
CAGTGCGGTCACTAGT	L:T:CD4:Naive
CATACAGGTGCAACAG	L:T:CD8:Naive
CATCCACTCATAAGGA	L:T:CD4:Naive
CATCCGTAGGTAAGGA	L:T:CD8:EMRA
CATGCAAGTAGGAGGG	L:B:PC
CATGCGGGTATCTCGA	L:T:CD8:EMRA
CATTCCGGTTAGGCCC	L:T:CD4:Naive
CCACCATAGTACTCGT	L:T:CD4:CM
CCGATCTAGATAGTGT	L:T:CD4:Naive
CCGTGAGAGAATAACC	L:T:CD8:EMRA
CCGTTCACACGTTCGG	L:T:CD4:CM
CCTAAGAAGAGCTGAC	L:T:CD4:CM
CCTGCATTCTTAATCC	L:T:CD8:EMRA
CGAGGCTTCTATTTCG	CD34
CGAGTTACATAGTCAC	L:T:CD4:Naive
CTAAGTGAGGTTCCGC	L:T:CD4:Naive
CTACAGAGTGTGACCC	L:T:CD8:EMRA
CTACCCAAGGTAGATT	L:T:CD4:CM
CTACCTGAGGTTATAG	L:T:CD8:EMRA
CTACCTGCACGTGAGA	L:T:CD4:Naive
CTATAGGCAGAAGCTG	L:T:CD4:CM
CTCATCGCACAATGCT	L:T:CD8:EMRA
CTCCCTCAGTCATGCT	L:T:CD4:CM
CTCGAGGCACATTCTT	CD34
CTGAGCGAGAAGTCCG	L:NK
CTGAGGCTCGAAGGAC	L:T:CD4:CM
CTGCCTATCTGCGTCT	L:T:CD4:CM
CTGTGAACATGCCGCA	L:T:CD4:EM
CTGTGAATCCTGCCAT	L:T:CD4:Naive
GACACGCTCGTTATCT	L:T:CD4:EM
GACTATGTCCATACAG	L:T:CD4:Naive
GACTCTCAGCTTTCTT	L:T:CD8:EMRA
GACTCTCGTGTGCCTG	L:T:CD4:EM
GAGGGTACACAGCTTA	L:B:PC
GATAGCTCAGCGGTCT	L:T:CD4:CM
GATTCGAAGCCTTTGA	L:T:CD8:EMRA
GCCAGCATCGATACGT	L:B:PC
GCCCAGAAGGCATTTC	L:T:CD4:Naive
GCGAGAATCACGTAGT	L:T:CD8:EM
GCTACAAGTGAGAACC	L:T:CD4:Naive
GGAGCAAAGCTGGCCT	L:T:CD4:Naive
GGGACAATCCTTGACC	L:NK
GGGAGATCAATGAAAC	L:T:CD8:EMRA
GGGAGTACAAAGTATG	L:T:CD8:EM
GGGAGTATCCCTGTTG	L:T:CD4:CM
GGGATGACACGACCTG	L:T:CD4:CM
GGTCACGGTCAGTCCG	L:T:CD8:Naive
GGTTGTAGTTGTGCAT	L:T:CD8:Naive
GTAATCGTCGAGAATA	L:NK
GTAATCGTCTCCTGTG	L:T:CD8:EM
GTACAGTCACAATGTC	L:T:CD4:Naive
GTCAAGTTCCAGTTCC	L:T:CD8:EMRA
GTGACGCCAGTCCCGA	L:T:CD8:EMRA
GTGCAGCAGAAGGGAT	L:T:CD4:Naive
GTGGTTACAGATTCGT	L:T:CD4:Naive
TAACTTCGTTAGCGGA	L:T:CD8:EM
TACGTCCCACACGCCA	L:T:CD4:CM
TATTGGGCACGAAAGC	L:T:CD8:EMRA
TCACGGGAGTACTGTC	L:T:CD8:EMRA
TCAGGTACACTCCGGA	L:T:CD4:Naive
TCATGCCAGATGCCGA	L:T:CD4:CM
TCATTACCAGCACGAA	L:NK
TCATTACGTTATGTGC	L:T:CD4:CM
TCCTCCCCAAGTCCAT	L:T:CD8:EMRA
TGAGGGATCAGAGTGG	L:T:CD4:EM
TGCATCCGTCGTCGGT	L:T:CD4:Naive
TGTCCTGGTCTCCTGT	L:T:CD4:Tfh
TGTTTGTGTGATGGCA	L:T:CD8:EMRA
TTCCAATGTCTGTGCG	L:T:CD8:EMRA
TTCTAGTAGCATCAAA	L:T:CD8:EMRA
TTGCCTGGTCGGAAAC	L:T:CD8:EMRA
TTGTGTTTCCCAAGTA	L:T:CD4:CM
TTGTTCACACCTAAAC	L:T:CD4:CM
TTTACGTTCCTTATAC	L:T:CD4:Naive
TTTCAGTAGAAAGCGA	L:T:CD4:Naive
TTTCAGTCAGCATTGT	L:T:CD4:CM
AAACCCACACAGCGCT	L:T:CD4:CM
AAATGGACAATTGAGA	L:T:CD4:CM
AACCAACTCGCTGTCT	L:T:CD4:CM
AAGACAATCCCGAGAC	L:T:CD4:CM
AATCGTGCAATGGGTG	L:T:CD4:Naive
ACGGAAGGTAAGTAGT	L:T:CD4:CM
ACGTTCCTCGATTTCT	L:T:CD4:CM
ACTGATGTCAGGAACG	L:T:CD4:EM
ACTGCAACAAGCGCTC	L:T:CD8:EMRA
ACTTAGGAGCTTAAGA	L:T:CD8:EMRA
ACTTAGGTCGAGCCAC	L:T:CD8:EMRA
ACTTTCACACCTATCC	L:T:CD8:EMRA
ACTTTCAGTACGATGG	L:T:CD8:EMRA
AGAACCTAGAAATTGC	L:T:CD4:CM
AGACCCGGTTTACCTT	L:T:CD4:CM
AGATGAAGTAGCGCTC	L:T:CD4:Naive
AGCCAGCTCACCTTGC	L:T:CD8:EMRA
AGCGATTAGTCCCAAT	L:T:CD4:Naive
AGGAAATCAATGACCT	L:T:CD8:EMRA
AGGACGATCTCTGACC	L:T:CD4:CM
AGGGCCTGTGTCTTGA	L:T:CD4:CM
AGGGCTCAGCATTGAA	L:T:CD4:CM
AGGGTTTAGTAGGCCA	L:T:CD8:CM
AGGGTTTTCACGAGGA	L:B:PC
AGTGTTGAGCTACAAA	L:T:CD8:EMRA
AGTGTTGCACGAGGAT	L:T:CD4:Naive
AGTTCCCGTTGGGATG	L:T:CD4:Naive
AGTTCCCTCACATACG	CD34
ATCCGTCTCGGTCACG	L:T:CD8:CM
ATCGGATCAGGGATAC	L:T:CD8:EMRA
ATCGGATCATAACTCG	L:T:CD8:EMRA
ATCGTAGTCGATGCAT	L:T:CD4:EM
ATGCCTCCATGATAGA	L:T:CD4:Naive
ATGGGTTTCATTACTC	L:T:CD4:CM
ATGTCTTCATAAGCAA	L:T:CD4:CM
ATTCTTGGTGCCTAAT	L:B:PC
CACGTGGCATTGACCA	L:T:CD4:Naive
CACTGAATCGGCTATA	L:T:CD4:EM
CACTGGGTCTAGCATG	L:T:CD8:EMRA
CATCCACCAAGTAGTA	L:T:CD4:Naive
CATTCCGAGGTTATAG	L:B:PC
CATTGTTCAGGGCTTC	L:T:CD4:CM
CCAATGAAGTCGTCTA	L:T:CD4:Naive
CCACAAAGTGAACGGT	L:T:CD4:Naive
CCCATTGGTACTAACC	L:T:CD4:Naive
CCCTCAATCGTCCTCA	L:T:CD8:EMRA
CCGCAAGAGCATAGGC	L:NK
CCTCCTCAGGACTGGT	L:T:CD8:EMRA
CCTTGTGCAAAGAACT	L:T:CD4:CM
CGATGCGCAAATCAAG	L:T:CD4:Naive
CGGAACCGTTATGTGC	L:T:CD4:CM
CGGTCAGCAATCAGCT	L:T:CD4:CM
CGTCAAATCGGCTTGG	L:T:CD4:CM
CTACCCACATTGCCGG	L:T:CD8:Naive
CTACGGGAGCCATTCA	L:T:CD4:Naive
CTACGGGTCTCAACGA	L:T:CD8:EMRA
CTCAACCCAGCCTTCT	L:T:CD8:EMRA
CTCAAGAAGGCCTGCT	L:T:CD4:CM
CTCAATTTCCGTGGCA	L:T:CD4:CM
CTCATGCAGTGTAGAT	L:T:CD4:Naive
CTCATTATCGTTCCTG	L:T:CD4:Naive
CTCCATGAGGCTTTCA	L:T:CD4:Naive
CTCCGATTCCCATTCG	L:T:CD4:EM
CTGAGCGGTAGTTCCA	L:T:CD4:CM
CTGTACCAGAGTTGAT	L:NK
CTGTATTAGACGTCCC	L:B
CTGTATTTCTCCCAAC	L:T:CD8:EMRA
CTGTCGTAGAATCGTA	L:T:CD4:CM
GAATAGAGTTAAGCAA	L:T:CD8:EMRA
GAATCACCACCAAAGG	L:T:CD4:CM
GACACGCAGCGGTAGT	L:T:CD4:CM
GACCTTCAGGCATGCA	L:T:CD4:CM
GACTCAAGTAGCGCTC	L:NK
GAGACTTGTGGCTACC	L:T:CD4:Naive
GAGTCTAAGTGATCGG	L:T:CD8:EM
GAGTTACTCGATGGAG	L:T:CD4:Naive
GAGTTGTGTTGGGCCT	L:NK
GATCACACACATCCCT	L:NK
GATTCGAGTGAATAAC	L:T:CD8:EM
GCCTGTTTCTGCTGAA	L:T:CD4:EM
GCTTTCGAGGCCCACT	L:T:CD4:EM
GGAGATGGTCTCACGG	L:T:CD4:CM
GGAGATGTCCCAATAG	L:T:CD4:EM
GGCTGTGAGAAATCCA	L:NK
GGCTGTGGTTCCGCTT	L:T:CD4:CM
GGGAAGTCAGAATTCC	L:T:CD4:EM
GGGTCTGCATGTCTAG	L:T:CD4:CM
GTACAGTAGTTACGTC	L:T:CD4:CM
GTCATGACAAACTGCT	L:NK
GTCCACTGTGTTCGAT	L:T:CD4:Naive
GTCCTCAGTACGGATG	L:T:CD4:CM
GTCTCACTCTTCGTGC	L:NK
GTGAGCCGTCGTACAT	L:NK
GTGAGGAAGACTAGAT	L:T:CD4:CM
GTGCTGGGTTAATGAG	L:T:CD4:Naive
GTGTAACTCATTACTC	L:T:CD4:Naive
GTTAGACGTCCCGCAA	L:T:CD4:Naive
GTTAGACTCCAAGCAT	L:NK
GTTAGACTCGGCAGTC	L:T:CD4:EM
GTTCATTCAGGCAATG	L:NK
TACTGCCTCACCATGA	L:T:CD4:Naive
TATACCTAGCTGTTAC	L:T:CD4:CM
TATACCTGTTGCTCAA	L:T:CD4:CM
TCATGTTAGGTTTACC	L:T:CD8:EM
TCATTCATCCCTAGGG	L:T:CD4:Naive
TCATTTGCAGCTCGGT	L:T:CD4:Naive
TCCAGAAGTCGGAAAC	L:T:CD8:EMRA
TCCCATGAGAGAAGGT	L:T:CD8:EM
TCTCACGAGGTTGCCC	L:T:CD8:Naive
TCTGTCGCAAACTGCT	L:T:CD8:EMRA
TGAACGTTCCTATTTG	L:T:CD8:EMRA
TGAATCGAGGTCCAGA	L:T:CD4:CM
TGGATGTCAATAGTCC	L:T:CD8:EMRA
TGGGTTATCCATTCGC	L:T:CD8:EMRA
TTACCATGTTGTCCCT	L:T:CD4:Naive
TTAGGCATCTATACTC	L:T:CD4:CM
TTATTGCAGTGTCATC	L:T:CD8:EMRA
TTATTGCGTTTACCTT	L:T:CD4:CM
TTCCTCTGTGTTAACC	L:T:CD8:EM
TTCTTCCGTACCCACG	L:T:CD4:EM
TTGATGGTCGAGGCAA	L:T:CD4:Naive
TTGCATTTCCCATTCG	L:T:CD4:CM
TTGTTTGCACTTGAAC	L:T:CD4:Naive
TTTACGTCACAAATAG	L:T:CD8:Naive
TTTCAGTCAAACAGGC	L:T:CD4:Naive
TTTCCTCGTGCTGCAC	L:T:CD8:EM
AAACCCAGTTCGTACA	L:T:CD4:CM
AAATGGAAGCCTTCTC	L:T:CD4:CM
AACGGGATCTTCACGC	L:T:CD4:Naive
AAGAACAGTCTGTGGC	L:T:CD4:CM
AATCACGAGACCCTTA	L:T:CD4:EM
AATTCCTGTCTGTGAT	L:T:CD4:Naive
AATTTCCAGTTCCTGA	L:T:CD4:CM
ACACGCGCACAACATC	L:T:CD8:EMRA
ACAGAAAAGCGCCATC	L:T:CD8:Naive
ACCAAACGTGCGACAA	L:T:CD8:EMRA
ACCTACCGTGTACAGG	L:T:CD4:EM
ACGGAAGGTATAGCTC	L:T:CD4:CM
ACGGTTAGTTGCTCGG	L:T:CD4:CM
ACGTACAAGACAAGCC	L:NK
ACGTACAGTAATCAGA	L:T:CD8:EMRA
ACTATGGAGATCCGAG	L:T:CD8:Naive
ACTATGGGTCCACTCT	L:T:CD4:Naive
ACTGCAACACAGTGAG	L:T:CD8:EMRA
ACTGTGAGTACAGTAA	L:T:CD8:EMRA
AGACAGGCAGATTCGT	L:T:CD8:EMRA
AGAGAGCTCTGTTGGA	L:T:CD8:EMRA
AGATAGAAGTTGGGAC	L:NK
AGATGAAGTAGGGAGG	L:T:CD4:EM
AGATGCTAGGCGAAGG	L:T:CD4:Naive
AGCTTCCCAATCCTAG	L:T:CD8:EMRA
AGGGAGTCAGTGGGTA	L:T:CD4:Naive
AGGTAGGCAACGATTC	L:T:CD8:Naive
AGGTCTAAGGCCTTCG	L:T:CD8:EMRA
AGGTTACAGTGCTACT	L:T:CD4:CM
AGTAGCTAGAATTGCA	L:T:CD4:Naive
AGTGTTGCAGAAATCA	L:T:CD4:CM
AGTTCGAAGTACTCGT	L:T:CD4:Naive
ATCCTATAGAGTGACC	L:T:CD8:EMRA
ATCTCTAAGGTACAGC	L:T:CD4:CM
ATGATCGGTGCCTTCT	L:T:CD8:Naive
ATGCATGTCCTTGAAG	L:T:CD8:EMRA
ATGCCTCTCTCTGAGA	L:T:CD8:EMRA
ATGGGTTTCGGATACT	L:T:CD8:EMRA
ATGTCTTAGTTGCGCC	L:T:CD4:CM
ATTCAGGGTCGACTTA	L:T:CD8:EM
ATTCTTGGTCCTTAAG	L:T:CD4:CM
ATTGGGTAGATGCCGA	L:T:CD8:EMRA
ATTTACCGTCACCTTC	L:B:PC
CAACAGTAGCGATCGA	L:T:CD8:CM
CAACCAAGTGAGCAGT	L:T:CD4:Treg
CAATCGACAAGAATAC	L:T:CD4:Naive
CACAGGCAGCAAATCA	L:T:CD8:EM
CACTGTCTCTACACTT	L:T:CD4:CM
CAGCACGCAATTTCTC	L:T:CD4:CM
CAGTTAGAGCCGAATG	L:T:CD8:EMRA
CATCCACTCGTAGGGA	L:T:CD4:CM
CATCGGGTCTAGAACC	L:T:CD8:EMRA
CATGAGTTCCACTGAA	L:T:CD4:Naive
CCCTGATAGGCGCTTC	L:T:CD8:EMRA
CCGTGAGTCCGCAGTG	L:B:PC
CCTAACCTCATTACGG	L:T:CD4:Naive
CCTACGTAGGACTATA	L:T:CD4:CM
CCTATCGGTATGTCAC	L:T:CD8:EMRA
CGAGTTACACAAACGG	L:T:CD4:Naive
CGAGTTATCAGGAAAT	L:T:CD4:CM
CGGAATTAGTTTAGGA	L:T:CD4:CM
CTACTATCAAGTGTCT	L:T:CD8:EMRA
CTAGACATCCAGTGCG	L:T:CD8:EMRA
CTAGACATCGCAGTGC	L:NK
CTCACTGCAGTCAGAG	L:T:CD4:Naive
CTCACTGTCACTTTGT	L:T:CD4:CM
CTCCTTTCAGTGTGGA	L:T:CD4:CM
CTGCATCAGCGATGCA	L:T:CD4:EM
CTGGACGAGGCAGGTT	L:T:CD8:EMRA
CTGGCAGAGAAGCGGG	L:T:CD4:Naive
CTTCCGACATAATGAG	L:T:CD4:Naive
CTTGAGAGTCCAGGTC	L:T:CD4:Naive
CTTGATTGTGTAGGAC	L:T:CD8:Naive
GACACGCAGTATGTAG	L:T:CD4:CM
GACGCTGTCAGTCACA	L:T:CD8:EMRA
GAGTCATTCTGGCCAG	L:T:CD4:Naive
GAGTGTTCAAACTAAG	L:T:CD8:EM
GCAGGCTTCTACGCGG	L:T:CD4:CM
GCCATTCCAGTAACCT	L:T:CD8:EMRA
GGAGCAAGTCAGTTTG	L:T:CD8:EMRA
GGCAGTCCACAAATAG	L:T:CD8:EMRA
GGGCCATAGCACGTCC	L:T:CD8:EMRA
GGGCTCACACAACCGC	L:T:CD4:Naive
GGGTCTGTCAAATAGG	L:T:CD8:EMRA
GGTGAAGGTGTTTGCA	L:T:CD4:CM
GTCCCATTCGGCCTTT	L:T:CD8:EMRA
GTGCACGTCTGCTTAT	L:T:CD4:CM
GTGCTTCAGCACCCAC	L:T:CD4:CM
GTGCTTCTCCTCTCTT	L:T:CD8:EM
GTGGAGATCCTTATGT	L:T:CD8:EM
GTTAGACTCCCTTGGT	L:T:CD4:CM
GTTATGGAGGTCCTGC	L:T:CD4:Naive
GTTATGGCAGGTTTAC	L:T:CD4:Naive
TAACTTCTCCTAAGTG	L:T:CD4:CM
TAAGTCGAGGTGAGAA	L:T:CD8:EMRA
TAATCTCAGCCGATAG	L:T:CD4:Tfh
TACCCACCATCTAGAC	L:T:CD8:EMRA
TACCGAATCCTGGTCT	L:T:CD4:CM
TACTTCAGTGGTCTGC	L:T:CD4:EM
TACTTGTTCCGATAAC	L:NK
TAGACTGAGGCGACAT	L:T:CD4:CM
TAGGAGGTCTCGAACA	L:T:CD8:Naive
TAGGGTTTCCACGAAT	L:T:CD8:EMRA
TATCAGGGTGGGTTGA	L:T:CD4:Naive
TATCAGGGTTAGAAGT	L:T:CD4:Naive
TATCGCCAGAAATTCG	L:B:PC
TATTCCACAGCTTTCC	L:T:CD4:EM
TCACGCTTCTGCCTGT	L:T:CD4:Tfh
TCAGTTTGTCTAGGTT	L:T:CD4:CM
TCATACTGTCGCTCGA	L:T:CD4:CM
TCATGTTCACGTAACT	L:T:CD4:EM
TCCGATCTCGTTCAGA	L:T:CD4:EM
TCCTAATAGGCCTAAG	L:T:CD4:EM
TCGACCTGTTCTCACC	L:T:CD4:CM
TCGATTTTCTTGATTC	L:T:CD4:Tfh
TCGCACTAGGGTTAGC	L:T:CD4:Naive
TCTACATCAGTATTCG	L:T:CD4:CM
TCTTAGTAGGCCTAGA	L:T:CD4:Naive
TGAATGCGTTGGACCC	L:T:CD8:EMRA
TGCGATAAGAGTTGCG	L:T:CD8:Naive
TGCGATAAGCGCTTCG	L:T:CD8:EMRA
TGGAGGACAGTTAAAG	L:NK
TGTAAGCAGGTGAGCT	M:pDC
TGTCCACAGTGCAACG	L:T:CD4:Naive
TGTTCCGCAGTAACCT	L:T:CD4:CM
TTACAGGAGTCAAGCG	L:T:CD4:CM
TTACTGTTCAGCTGTA	L:NK
TTCATTGAGTGCACTT	L:T:CD8:Naive
TTGATGGGTGCCGGTT	L:T:CD4:Naive
TTGGATGTCGGAACTT	L:T:CD4:Naive
TTGTTCATCATCGCTC	L:T:CD4:Naive
TTTACTGAGTTGTCAC	L:T:CD4:CM
TTTGATCAGCTAGATA	L:T:CD4:Naive
AAACGAAAGACAACAT	L:T:CD4:CM
AACACACAGTGGTGAC	L:T:CD4:EM
AATGGCTTCTGCTTTA	L:T:CD8:EMRA
ACGTACAAGACGTCCC	L:T:CD8:CM
ACTTATCTCATTCATC	L:T:CD4:CM
AGCCAATTCAGACCCG	L:T:CD4:Naive
AGGGAGTGTTGTGCAT	L:T:CD4:CM
AGGGTTTCAAATTGGA	L:T:CD8:EMRA
AGGTAGGTCATTCACT	L:T:CD8:EMRA
AGTAACCCACACGGTC	L:T:CD8:Naive
AGTAACCCACTCAGAT	L:T:CD8:EMRA
AGTAGCTGTTACTCAG	L:T:CD4:CM
ATAGACCGTTTCGTAG	L:NK
ATCCCTGCAGAACTCT	L:T:CD4:Naive
ATCGTGAGTTAATGAG	L:B:PC
ATTACCTTCTAGGCCG	L:T:CD4:Naive
ATTCATCTCTGCTGAA	L:T:CD8:EMRA
ATTCCATTCCATCTCG	L:T:CD4:CM
ATTCCCGCAAACGGCA	L:T:CD4:Naive
ATTCCTACAACTAGAA	L:T:CD4:Naive
CAACAACCACAATCTG	L:T:CD4:CM
CACTGGGAGTGCACAG	L:T:CD4:Naive
CACTGTCCATGTTCGA	L:T:CD8:EMRA
CATGAGTAGTACCCTA	L:T:CD8:CM
CATTGCCCAGTTAGAA	L:T:CD8:EMRA
CATTGCCTCCGCGGAT	L:T:CD8:EMRA
CATTGTTAGTCCCGGT	L:T:CD4:Naive
CCACCATGTTCGGTCG	L:T:CD4:Naive
CCCTGATCAACCTATG	L:T:CD8:Naive
CCGAACGGTCGGCCTA	L:T:CD4:Naive
CCGATGGAGGACACTG	L:T:CD4:Naive
CCGGTAGGTCAGATTC	L:T:CD4:EM
CCTAAGAAGCATAGGC	L:B:PC
CGAATTGCAAAGGCAC	L:T:CD8:EMRA
CGGGTCAGTATGATCC	L:T:CD4:CM
CTACTATAGGCTCCCA	L:T:CD4:CM
CTCCCTCTCAAAGCCT	L:T:CD4:CM
CTCTCAGAGTTTGAGA	L:T:CD8:EMRA
CTCTCAGGTACATTGC	L:T:CD4:Naive
CTCTCGAGTGCCTACG	L:T:CD4:Naive
GAACTGTGTGCCCAGT	L:T:CD4:Naive
GACCGTGAGCTATCTG	L:T:CD8:EMRA
GAGAAATCATGTGTCA	L:NK
GAGAGGTAGCAAGTGC	L:T:CD4:CM
GAGCTGCCATACTGTG	L:T:CD4:Naive
GATAGAACATAACGGG	L:T:CD4:CM
GATGAGGCATCAGCGC	L:T:CD8:EMRA
GCACTAAAGAATACAC	L:NK
GCCAGCAGTATTGACC	L:T:CD8:EMRA
GCCAGGTGTGAATTGA	L:T:CD8:EMRA
GCTCAAAAGTATAACG	L:T:CD4:EM
GCTCAAACAAGAGGCT	L:T:CD8:EMRA
GGAAGTGCATGGTACT	L:T:CD4:CM
GGGAAGTTCACCCTTG	L:T:CD4:CM
GGGTAGAAGCACCAGA	L:T:CD4:Naive
GGGTGAAAGTCGAATA	L:T:CD4:Naive
GGGTGAATCCTGTAAG	L:T:CD4:Naive
GGTAACTTCAAAGAAC	L:T:CD8:EM
GGTGTCGGTTTGGGTT	L:T:CD4:Naive
GTAAGTCCAGAATTCC	L:T:CD8:EMRA
GTAGAGGGTGGCTGAA	L:T:CD4:CM
GTATTGGAGGATTCCT	L:T:CD8:EM
GTATTTCCAAGCACAG	L:T:CD4:CM
GTGCAGCCATGTGCTA	L:T:CD4:CM
GTGTGATTCCATCTGC	L:T:CD4:Tfh
GTTACCCTCGTTACCC	L:T:CD8:EMRA
GTTGAACTCCTACGGG	L:T:CD8:EM
TAACGACCAAGAGTGC	L:T:CD8:EM
TAAGCCAAGTTTCGAC	L:T:CD4:Naive
TAAGCGTTCCCTGGTT	L:T:CD4:CM
TACAACGTCGCATTGA	L:T:CD4:CM
TACCGAACATCCGGTG	L:T:CD8:Naive
TAGGTTGAGACCGCCT	L:T:CD8:Naive
TATATCCGTATGTCTG	L:T:CD4:CM
TATCGCCAGTACAGCG	L:T:CD4:CM
TCAGGGCGTAACACGG	L:T:CD4:CM
TCATTCACAAACGTGG	L:T:CD4:Naive
TCATTTGGTAACGATA	L:T:CD4:CM
TCTATACCAAGAAACT	L:T:CD4:Naive
TCTCCGATCGAGATGG	L:B:PC
TCTGTCGCAGGATTCT	L:NK
TGAATCGGTAACCCTA	L:T:CD4:CM
TGAGCATTCCAAGCAT	L:T:CD4:Naive
TGATCAGTCCACCCTA	L:T:CD4:CM
TGATCTTCATCTAACG	L:T:CD4:Naive
TGATCTTGTACGCTAT	L:T:CD4:CM
TGATTTCTCGCCAATA	L:T:CD4:Naive
TGCAGTAGTAACGATA	L:T:CD4:Naive
TGCATGAGTCAACGCC	L:T:CD8:EMRA
TGCGATATCATTACCT	L:T:CD8:EMRA
TGCTCCACATGAAGGC	L:T:CD4:CM
TGGGATTGTTCTTGCC	L:T:CD8:EMRA
TGGTACAGTAGAGACC	L:B:PC
TGTAAGCCAAGTGATA	L:T:CD8:EMRA
TTACGCCGTAGAGCTG	L:T:CD8:Naive
TTAGGCACAAACTAGA	CD34
TTCACCGAGATCCGAG	L:T:CD8:EMRA
TTCAGGACATGACGTT	L:T:CD4:CM
TTCTCTCTCGGCTATA	L:T:CD8:EM
TTGCTGCTCCGGTTCT	L:T:CD4:CM
TTGTTCACATGAGGGT	L:T:CD4:Naive
TTGTTTGAGACTTGTC	L:T:CD8:EMRA
TTTACTGCAAGGTCGA	L:T:CD4:Naive
TTTATGCCAAACACCT	L:T:CD4:CM
TTTGGAGGTTACGCCG	L:T:CD4:EM
AACGTCATCCGAAATC	CD34
AACTTCTTCCATCGTC	L:T:CD4:CM
AAGCCATTCGTGGACC	L:T:CD4:Naive
AAGCGAGCATCTGTTT	L:T:CD8:EMRA
AATGGAACAGCAGTTT	L:T:CD4:EM
ACAGAAAAGAAGGGAT	L:T:CD4:CM
ACAGCCGAGTGGCAGT	L:T:CD4:Naive
ACCATTTAGCGTGTTT	L:T:CD8:EMRA
ACTATCTTCGATTGAC	L:T:CD4:Naive
ACTTTCACATTGCAAC	L:T:CD8:EMRA
AGACAAACACTGAATC	L:T:CD8:EMRA
AGACAGGGTGCACAAG	L:T:CD4:CM
AGCATCAAGACTCGAG	L:T:CD4:Tfh
AGCATCATCCTCGCAT	L:T:CD4:CM
AGCTCAACACAACGTT	L:NK
AGGAAATAGTCTGGAG	L:T:CD4:CM
AGGAGGTGTTATTCCT	L:B:PC
AGGAGGTTCGTTCTCG	L:T:CD4:CM
AGGTTGTCACAACGAG	L:T:CD4:CM
AGTAGCTAGAGGATGA	L:T:CD8:Naive
AGTGACTTCCCTTCCC	L:T:CD8:EMRA
AGTGACTTCCGCGATG	L:T:CD8:EMRA
ATCCATTTCTGTTGGA	L:T:CD8:EMRA
ATCGCCTGTAATGCTC	L:T:CD8:EM
ATGAGTCAGCAATAGT	L:NK
ATTGGGTCAATAGTGA	L:T:CD4:Naive
CAACAACAGTTCTACG	L:T:CD4:Naive
CAACAACGTTGCACGC	L:T:CD4:CM
CAACGGCGTTCAATCG	L:T:CD8:CM
CACCAAAAGGAATCGC	L:T:CD4:CM
CACGGGTTCTACAGGT	L:T:CD4:Naive
CAGCCAGAGTACCGGA	L:T:CD8:EMRA
CAGCCAGTCTGTTGGA	L:T:CD4:Naive
CAGGCCACACGCTGCA	L:T:CD4:CM
CATCCACAGAGAGTGA	L:T:CD4:Naive
CATCCACCAGACCATT	L:T:CD4:Naive
CATTCCGAGAAGATCT	L:NK
CCGATCTGTCCCGCAA	L:T:CD8:EMRA
CCGGACAGTTCACCGG	L:B:PC
CCGTGAGCAGCTGGTC	L:T:CD8:EMRA
CCTCAACAGCTATCTG	L:T:CD8:EMRA
CGGGACTCAGTCAGAG	L:T:CD4:Naive
CTACCCAAGAGATTCA	L:T:CD4:CM
CTCAATTAGGTAAGAG	L:T:CD8:EMRA
CTCACTGTCTACGCGG	L:T:CD4:Naive
CTGAGGCTCCTGGGAC	L:T:CD4:CM
CTGATCCGTGTCCACG	L:NK
CTTAGGAAGCATCGAG	L:T:CD4:CM
CTTAGGATCCTGCCAT	L:NK
GAACACTTCATTACCT	L:NK
GAACTGTCATCCGCGA	L:T:CD4:CM
GAAGAATCATCCGATA	L:T:CD8:EMRA
GACCCTTCAAACTAAG	L:T:CD8:Naive
GAGAAATAGTCAGGGT	L:T:CD8:Naive
GATCATGGTTCGTGCG	L:T:CD8:Naive
GATCCCTGTTACGGAG	L:T:CD4:CM
GCATTAGTCTCTTCAA	L:T:CD8:CM
GCCATGGAGTCATTGC	L:T:CD4:CM
GCCATGGTCCGTATGA	L:T:CD4:CM
GCTACAAGTGCAACAG	L:T:CD4:EM
GCTACCTTCGGTGTTA	L:T:CD4:Naive
GCTGGGTGTCAGCGTC	CD34
GGCGTCAAGCTGTCCG	L:NK
GGCTTTCCAACGACTT	L:T:CD4:CM
GGGACCTGTCGTCGGT	L:T:CD4:Naive
GGGTCTGGTAGCTAAA	L:T:CD4:EM
GTAATCGTCAAGGAGC	L:T:CD4:Naive
GTAGGAGCAGGAGGTT	L:T:CD8:EMRA
GTGACGCGTGATGGCA	L:T:CD4:CM
GTTACGACATATTCGG	L:T:CD8:CM
GTTCATTTCTTCGACC	L:T:CD8:EMRA
GTTGTCCGTCATGCAT	L:T:CD4:Naive
GTTTACTCATGACAAA	L:T:CD4:Naive
TACCCGTCAACTCGAT	L:T:CD4:Naive
TACGGGCTCTAGACAC	L:T:CD8:EMRA
TAGATCGCAGTCTGGC	L:T:CD4:CM
TATACCTTCCTCGCAT	L:B:PC
TATCGCCAGCAAGTGC	L:T:CD8:EMRA
TATCTTGAGTTGGAAT	L:T:CD8:Naive
TCAGGGCCACCCATAA	L:T:CD4:Naive
TCAGTTTGTTCGGTTA	L:T:CD4:Naive
TCCTCCCCAGCATTGT	L:T:CD4:Naive
TCGACCTGTACAAGTA	L:T:CD4:Naive
TCTTAGTGTGGCTTGC	CD34
TGACCCTGTCTTTCAT	L:T:CD4:CM
TGAGACTTCTTTGCAT	L:T:CD4:CM
TGATGGTCATCCGTTC	L:T:CD4:Naive
TGCTCGTGTGCATCTA	L:T:CD4:Naive
TGCTTCGAGATTGAGT	L:T:CD8:EMRA
TGTCAGATCGCACGAC	L:NK
TGTGCGGTCCCGAGAC	L:T:CD8:EMRA
TTCATGTGTATCTCGA	L:T:CD8:EMRA
TTCCACGGTGTCATTG	L:T:CD8:EMRA
TTGTGGATCACACCGG	L:T:CD4:CM
TTTGGTTAGCACACCC	L:T:CD4:CM
AAACGAAAGATGCCGA	L:T:CD4:CM
AAAGGATTCCTTTGAT	L:T:CD4:CM
AAAGGTAAGTTGGCGA	L:T:CD4:CM
AACCTGAAGCCTAGGA	L:T:CD4:Naive
AAGTACCAGTGGAAGA	L:T:CD4:Naive
AATGACCCAGCCCACA	L:T:CD4:Naive
ACAAAGACAGTTGTTG	L:T:CD4:CM
ACAGAAATCGCTTTAT	L:T:CD8:EMRA
ACAGAAATCTGCGGGT	L:T:CD4:CM
ACCTGAAAGTGATGGC	L:T:CD8:EMRA
ACGTACACAGCGTTTA	L:T:CD4:Naive
ACTATGGCAGCTGAAG	L:T:CD4:Naive
ACTCTCGTCCCTCGAT	L:T:CD8:Naive
AGCGTATAGCCTAACT	L:T:CD8:EMRA
AGCGTATCAGTTGGTT	L:T:CD8:EMRA
AGGTAGGTCGCCATAA	L:T:CD4:Naive
AGTAGTCCAGCGTAGA	L:T:CD4:EM
AGTGTTGAGAGTCAGC	L:T:CD8:EMRA
AGTTAGCGTACTCGAT	L:T:CD4:Naive
ATCCACCGTGAGCAGT	L:T:CD4:CM
ATGTCTTCAGCAGGAT	L:T:CD8:Naive
ATTTCACCAGGATCTT	L:T:CD8:EM
CAACGATCACAAATGA	L:T:CD8:Naive
CAAGACTCAACGACAG	L:T:CD4:Naive
CACGTTCCAGATACCT	L:T:CD8:CM
CACTTCGAGGGCCTCT	L:T:CD4:CM
CAGCCAGGTACCTTCC	L:T:CD8:EMRA
CATGCGGGTAACGATA	L:T:CD4:CM
CCACGAGAGTGTAGTA	L:NK
CCATAAGAGTGCGACA	L:T:CD4:Naive
CCCTCAAGTGAGTGAC	L:T:CD8:Naive
CCGGACAGTGAGCGAT	L:T:CD8:EM
CCTGTTGTCAACCTCC	L:T:CD4:CM
CGATGGCTCGTAACAC	L:T:CD8:EM
CGCAGGTTCACTGCTC	L:T:CD4:Naive
CGCCAGACACTGTTCC	L:NK
CGGACACTCGGATTAC	L:T:CD4:CM
CGGGACTAGTGATAAC	L:T:CD8:EMRA
CGTGATATCCATCAGA	L:NK
CTACAGAAGTAAACGT	L:T:CD4:CM
CTATAGGAGATTGCGG	L:T:CD8:Naive
CTCAGAACAGTTAGAA	L:T:CD4:CM
GAACGTTCAATTGAGA	L:T:CD4:Naive
GAAGGGTTCGGTTCAA	L:T:CD8:Naive
GAATCACTCGTCACCT	L:T:CD4:Naive
GACCCAGAGTATCTGC	L:T:CD4:Naive
GACGTTAGTACGACAG	L:T:CD4:CM
GACTTCCCATTATGCG	L:T:CD8:EMRA
GATTCGAAGTATTAGG	L:B:PC
GATTGGTTCCAACCGG	L:T:CD8:Naive
GCACTAAAGCCGCTTG	L:B:PC
GCAGTTAAGACAACTA	L:T:CD4:Treg
GCAGTTAGTTGTCATG	L:T:CD4:EM
GCCAGCAAGCACTAAA	L:B:PC
GCTGGGTGTAGACAAT	L:T:CD8:EMRA
GGCTTTCCATGGCCCA	L:T:CD8:CM
GGGACAAGTACAGGTG	L:T:CD4:CM
GGGTAGATCCCATACC	L:T:CD4:Naive
GGGTCTGGTGCACGCT	L:T:CD4:CM
GGGTTTAAGGCATTTC	L:T:CD4:CM
GTACAGTGTACAGTAA	L:T:CD4:CM
GTAGATCTCGGCACTG	L:T:CD4:CM
GTATTTCTCTGGACTA	L:T:CD8:Naive
GTGATGTCATTGAGCT	L:NK
GTGCAGCAGGTAAACT	L:T:CD4:CM
GTGTTCCGTCTAGGCC	L:T:CD4:Naive
GTTACGAGTGTGAATA	L:T:CD8:EM
GTTCATTGTAATGCGG	L:T:CD4:CM
TAAGCACCATATAGCC	L:T:CD4:Naive
TACCCGTCAGAGGACT	L:T:CD4:Naive
TACCGGGTCGTAGCCG	L:B:PC
TAGATCGAGACGGAAA	L:T:CD4:Naive
TAGTGCATCGATTGAC	L:T:CD8:EMRA
TATTGGGTCCTCTCTT	L:T:CD8:EMRA
TCAATTCCACCTCTGT	L:T:CD8:EM
TCATGCCAGTGCAACG	L:T:CD4:Naive
TCCTAATGTTGAGTCT	L:T:CD8:EMRA
TCCTCGACACCCAAGC	L:T:CD4:CM
TCCTTCTGTCATCGGC	L:T:CD4:CM
TCCTTCTGTTCTTGTT	L:T:CD4:Naive
TCTTAGTCACACACTA	L:T:CD8:Naive
TGAACGTAGAGTGGCT	L:T:CD8:EMRA
TGATCAGAGCCACTCG	L:T:CD8:EM
TGCATGAAGGATGGCT	L:B:PC
TGCTTCGGTCGCAACC	L:NK
TGGATGTTCTCGCAGG	L:T:CD4:EM
TGTAACGCAGTACTAC	L:T:CD8:EMRA
TGTGAGTAGAAACTGT	L:T:CD4:CM
TGTTTGTCAAGACGGT	L:T:CD4:Naive
TTCCAATTCATCCTGC	L:T:CD8:EM
TTCCGGTGTCGACGCT	L:T:CD4:Naive
TTGCATTCATCGATCA	L:T:CD8:Naive
TTGGGTATCACACGAT	L:T:CD4:Naive
TTTGGAGTCCACCTGT	L:T:CD4:Naive
AAACGCTTCACTTATC	L:T:CD8:Naive
AACACACTCATATGGC	L:T:CD4:Naive
AAGCATCAGTGTTCCA	L:T:CD4:CM
AATGGCTAGAGCATAT	L:T:CD8:EMRA
AATTTCCGTCACTCGG	L:T:CD4:CM
ACAACCACAGTAACGG	L:T:CD4:CM
ACATGCACAGTCGAGA	L:T:CD4:CM
ACCCTTGAGCTGGCTC	L:T:CD4:CM
ACCGTTCAGGGAGGTG	L:T:CD4:Naive
ACCTGTCAGTGCAGGT	L:T:CD4:Naive
ACTACGATCGACGAGA	L:T:CD4:Naive
ACTCCCAAGTCTCTGA	L:NK
AGATAGACACCGCTGA	L:T:CD4:Naive
AGCCACGTCGCCTATC	L:NK
AGCGCCAAGTTATGGA	L:NK
AGCTACAGTATCGCAT	L:T:CD4:Naive
AGGACTTCAACTGGTT	L:T:CD4:CM
AGGTCATAGACCTCCG	L:T:CD4:CM
ATACCTTAGGTATTGA	L:B:PC
ATAGACCCATGTGTCA	L:T:CD8:Naive
ATCGTAGCACTATCCC	L:T:CD8:EMRA
ATTCACTGTGCCCGTA	L:B:PC
CAACCTCCAATGGCAG	L:T:CD4:Naive
CAAGACTAGAGAGGTA	L:T:CD4:CM
CAATTTCGTTCTTAGG	L:T:CD8:EMRA
CACCAAATCCGTGTCT	L:T:CD4:CM
CACCGTTGTAATCAAG	L:NK
CAGAGCCCACCAGGTC	L:NK
CAGTTAGTCGATGGAG	L:T:CD4:EM
CATACCCAGCAATTCC	L:T:CD8:EM
CATGCGGGTCGCTTAA	L:T:CD8:EMRA
CATTCTAGTCAGACGA	L:T:CD4:Naive
CATTTCACAAGTATCC	L:T:CD4:CM
CCAATTTCACGTCTCT	L:T:CD4:Naive
CCTAACCAGCGTATGG	L:T:CD4:Naive
CCTGTTGCAACCAACT	L:T:CD4:CM
CGAGGCTCAGGACTAG	L:T:CD8:EMRA
CGGGTCAGTGAGCCAA	L:T:CD4:CM
CGGTCAGGTCACTAGT	L:T:CD8:EMRA
CTAACCCTCGTGGTAT	CD34
CTAGACAGTTGTCTAG	L:T:CD4:Naive
CTCAAGATCCAGCCTT	L:NK
CTCAGTCCATAGATGA	L:T:CD4:CM
CTGAGGCAGGGTATAT	L:T:CD8:EMRA
CTGGTCTCAGGCTCTG	L:T:CD4:Naive
GAAACCTCACACCAGC	L:T:CD8:Naive
GACCAATGTACGGGAT	L:T:CD4:CM
GACCCTTGTACTAACC	L:T:CD8:EMRA
GACTCAAAGCTTTGTG	L:T:CD4:Naive
GATGCTAGTATTGACC	L:T:CD8:EMRA
GATGTTGGTACAATAG	L:T:CD8:EMRA
GCAGTTAAGTACCATC	L:B:PC
GCCATTCTCGTAACCA	L:T:CD4:Naive
GCGGATCCAAGACCGA	L:T:CD4:CM
GGAATGGCAGTTCTAG	L:T:CD8:CM
GGCAGTCTCGGACCAC	L:T:CD8:EMRA
GGGAGTAAGCTGTACT	L:B:PC
GGGCGTTCATGTTTGG	L:T:CD4:Naive
GTATTTCGTAGTGCGA	L:T:CD4:EM
GTGCTTCAGTATAGGT	L:T:CD8:Naive
GTTGAACAGGTGAGAA	L:T:CD4:Naive
TAACACGAGTATGAAC	L:T:CD4:Naive
TAACCAGTCGCACGAC	CD34
TAATTCCCAATCAAGA	L:NK
TACTTGTGTCTCTCCA	L:T:CD8:EMRA
TAGAGTCGTCCTACAA	L:T:CD8:EMRA
TATCCTATCCTCAGGG	CD34
TATTGCTGTAACGATA	L:T:CD4:Naive
TCCACCAAGCAGGCTA	L:T:CD8:EMRA
TCCATGCAGGTTGCCC	L:T:CD8:EMRA
TCGCACTTCGCCGATG	L:T:CD4:CM
TCTGCCAGTACAGCGA	L:T:CD4:CM
TGAACGTTCATTTACC	L:T:CD4:Naive
TGAATGCTCCGGTAGC	L:T:CD4:Naive
TGACCCTGTTGTATGC	L:T:CD8:EMRA
TGAGACTAGTCTGGAG	L:T:CD4:Naive
TGAGTCACAATGTCTG	L:T:CD4:Naive
TGGATCAGTTCGGTTA	L:T:CD8:EMRA
TGGGTTAGTCTGCGCA	L:T:CD4:CM
TGTAAGCGTGTCATGT	L:T:CD8:EMRA
TGTCCACGTCTCGGAC	L:T:CD4:Naive
TGTGAGTAGAGGTTAT	L:T:CD4:Naive
TGTGTGAGTACAGTTC	L:T:CD4:CM
TGTTACTCATTCGATG	L:T:CD4:CM
TTAGGCACAATCGCAT	L:T:CD4:CM
TTCCGGTGTGAACGGT	L:T:CD8:EMRA
TTGCCTGTCTCGTTTA	L:T:CD4:CM
AAATGGATCGCTTAAG	L:T:CD4:Naive
AACCATGCAGTGGTGA	L:T:CD4:CM
AAGCGTTGTTTACCTT	L:T:CD8:EMRA
AAGGAATGTGAATTAG	L:T:CD4:CM
AATGCCATCATACAGC	L:NK
ACCAAACGTGGACAGT	L:B:PC
ACCAAACGTTCGGCTG	L:T:CD4:CM
ACGCACGAGCCAAGCA	L:T:CD8:EM
ACGGGTCAGGCGCTCT	L:NK
ACGGTCGCAGAATGTA	L:T:CD4:CM
ACTTCCGGTCGTACAT	L:T:CD4:Naive
AGAACCTGTAGACGGT	L:T:CD4:CM
AGATAGATCTGTCTCG	L:T:CD4:CM
AGATCCAGTGGTATGG	L:T:CD8:Naive
AGGCTGCGTGAGAACC	L:T:CD8:EMRA
AGTCACACAGAGTCAG	L:T:CD4:Naive
AGTCATGTCTGGGCCA	L:NK
ATCACTTCATGTCTAG	L:T:CD4:CM
ATCCTATAGTGTCATC	L:T:CD8:EMRA
ATCGGATTCTGGGAGA	L:T:CD4:Naive
ATCGTAGTCCCGTTCA	L:T:CD4:CM
ATCTTCACAGCTATAC	L:T:CD4:CM
ATGGAGGAGAGTTGCG	L:T:CD4:Naive
ATTCAGGCAGTTGAAA	L:T:CD8:EMRA
CAACAACCACATTCGA	L:T:CD4:Naive
CAATGACGTCCACATA	L:T:CD8:EMRA
CAATTTCCATAGGTTC	L:NK
CAGCACGGTCGTGATT	L:B:PC
CAGCAGCAGACGCTCC	L:T:CD4:Naive
CATCCGTCACAAGGTG	L:T:CD4:CM
CCAATTTCATGGAATA	L:T:CD4:CM
CCCATTGTCATTCGTT	L:T:CD8:CM
CCTACGTAGTGTACCT	L:T:CD4:CM
CGGAATTCAACTTGCA	L:T:CD8:EMRA
CGGTCAGGTGTCTTAG	L:T:CD4:CM
CTAACTTAGTTCCTGA	L:T:CD8:EMRA
CTAGACATCTATTTCG	L:T:CD4:Naive
CTAGGTACAGAATTCC	L:NK
CTCAACCAGGCTTCCG	L:T:CD4:CM
CTCAGGGTCAGAATAG	L:T:CD4:EM
CTTACCGTCCTCATAT	L:NK
GAAGGACTCGAGATGG	L:T:CD4:Naive
GAATAGAGTTACGATC	L:NK
GACCCAGCAGCGTACC	L:T:CD8:Naive
GAGGGATGTCGTATTG	L:T:CD4:CM
GCAACATCAAAGCTCT	L:T:CD4:CM
GCAACCGCATATGGCT	L:T:CD8:EMRA
GCACATACAAAGCTAA	L:T:CD4:Naive
GCAGTTAGTCTACTGA	L:T:CD4:Naive
GCCAACGAGGAATTAC	L:T:CD4:CM
GCCAGGTAGATTACCC	L:T:CD8:Naive
GCCAGTGCAAGTGGTG	L:T:CD4:Naive
GCTCAAATCGCTTGCT	L:T:CD4:Naive
GCTTGGGAGACTTCCA	L:NK
GGAGGTACAATGTTGC	L:T:CD4:CM
GGCAGTCTCCTCTCTT	L:T:CD8:EMRA
GGGACAACAACATACC	L:T:CD4:CM
GGGTCTGCATCGGAAG	L:T:CD8:Naive
GGGTTTAAGCACTCCG	L:T:CD8:EMRA
GGTGTTAGTTTAGAGA	L:T:CD8:EMRA
GTAGCTAAGGGAGTGG	L:T:CD8:EMRA
GTCTTTAAGGTGTGAC	L:T:CD8:EMRA
GTGCTTCAGTACTGTC	L:T:CD4:EM
GTGGAGACACCCGTAG	L:T:CD8:EMRA
GTGGCGTAGTGGAAAG	L:T:CD4:CM
GTGTAACCAGTTTCGA	L:T:CD4:Naive
GTTCATTTCGCGGTAC	L:T:CD8:EMRA
GTTCGCTGTGAGATTA	L:T:CD4:Naive
GTTTGGAGTTCGGCCA	L:NK
TAACTTCTCTTCTGTA	L:T:CD4:Naive
TAGAGTCAGGTCTTTG	L:T:CD4:CM
TAGAGTCGTATGTGTC	L:T:CD8:EMRA
TATCTTGTCCGCACGA	L:T:CD8:EM
TCAAGCAAGCATTGTC	L:T:CD4:Naive
TCACGCTGTATTCCTT	L:T:CD8:EMRA
TCAGCAAGTCCTCCAT	L:B:PC
TCAGTGAAGAAGTGTT	L:T:CD4:Naive
TCATGAGTCGCCTATC	L:T:CD8:Naive
TCATTACTCGTTCATT	L:T:CD8:EM
TCATTTGGTGGAAGTC	L:T:CD8:EMRA
TCCCATGTCACACGAT	L:T:CD8:EM
ACAAAGAAGGCTGAAC	L:T:CD8:EM
TCTATCACAAGTTGGG	L:T:CD4:CM
TGACGCGAGGCTTAGG	L:T:CD8:EMRA
TGAGCGCCAGTGCGCT	L:T:CD8:EMRA
TGATTTCTCGTCGATA	L:T:CD4:EM
TGCACGGCATAGGTTC	L:NK
TGCAGTACAATGTTGC	L:B:PC
TGCATGATCTCTGACC	L:T:CD8:Naive
TGCCGAGGTCCGGATC	L:NK
TGGAGAGCAGGAGACT	L:NK
TGGAGGATCCGTAATG	L:T:CD4:Naive
TGGTACACACCCATAA	L:T:CD8:EM
TGTAAGCGTGACTAAA	L:T:CD8:EMRA
TGTGTGAGTTCCTAAG	L:T:CD4:Naive
TTCCGGTCATATCGGT	L:T:CD4:CM
TTCCGTGAGAGTAACT	L:T:CD4:CM
TTCCTTCAGTGGAAGA	L:T:CD8:EM
TTTCCTCGTGACACAG	L:T:CD4:CM
AAAGAACCAAACACGG	L:T:CD4:Naive
AAAGTGAAGCCTGTGC	L:T:CD8:CM
AACAAAGAGGCTCCCA	L:T:CD4:Naive
AACAGGGAGAAATTGC	L:T:CD4:Naive
AACCACACACCAGACC	L:T:CD4:CM
AAGGTAAGTAGCGCCT	L:T:CD8:EMRA
ACACTGACATGGACAG	L:T:CD8:EM
ACTCTCGTCCTTGACC	L:T:CD4:CM
ACTGTCCGTATGACAA	L:T:CD4:Naive
AGACAGGTCGTAACAC	L:T:CD4:CM
AGACCCGGTGTATTGC	L:NK
AGCGCTGCATACTGAC	L:T:CD4:Naive
AGTAACCTCTAGCAAC	CD34
AGTTAGCAGCAGCAGT	L:T:CD8:Naive
AGTTCCCAGGCCTGAA	L:T:CD4:EM
ATCAGGTGTCGCCACA	L:T:CD4:Naive
ATTCACTTCGTGCACG	L:T:CD4:CM
ATTCCTAAGCGATCGA	L:T:CD8:EMRA
CAATTTCAGAGTCCGA	L:T:CD4:Naive
CACCAAAAGAAGTGTT	L:T:CD8:EMRA
CACTGAAAGATAGTCA	L:T:CD8:EMRA
CATACCCCACAAATAG	L:T:CD4:CM
CATTCATCATTATGCG	L:T:CD8:EMRA
CCACCATCAACTGGTT	L:T:CD4:CM
CCCGGAACAACCGCTG	L:B:PC
CCCGGAATCTAACGGT	L:T:CD8:EMRA
CCTAACCTCACGATCA	L:T:CD8:EMRA
CCTCTAGAGGTATAGT	L:NK
CGGTCAGCATACACCA	L:B:PC
CTAGGTACAACCTAAC	L:T:CD4:EM
CTCCGATAGTGTACAA	L:T:CD4:CM
CTGAGCGGTAGGTTTC	L:T:CD4:Naive
GAAGAATAGCGAGTAC	L:T:CD8:EMRA
GACACGCCATCAACCA	L:T:CD8:Naive
GACCAATTCACGATAC	L:T:CD8:EMRA
GACCTTCCAGACGCTC	L:T:CD4:CM
GATCGTAGTGGTCTGC	L:T:CD4:CM
GATGAGGCATTGCTGA	L:T:CD4:CM
GATGAGGTCTTACTGT	L:T:CD4:CM
GCATCTCAGTAGAGTT	L:T:CD4:Naive
GCCGATGTCTACCAGA	L:T:CD4:Naive
GGAGAACTCCCTCTTT	L:T:CD4:Naive
GGAGATGGTCAGCTTA	L:T:CD4:Naive
GGGAAGTGTTCTTGCC	L:T:CD4:CM
GGGACTCTCCAACCGG	L:T:CD8:EMRA
GGGTTTAGTTGTGCCG	L:T:CD8:Naive
GTAGGTTAGTCATGAA	L:T:CD4:CM
TACGGGCGTGGTTTAC	L:T:CD4:Naive
TCATCCGGTCACATTG	L:T:CD8:EMRA
TCATTACCATCCTTGC	L:T:CD4:CM
TCCATCGAGGGAGGGT	L:T:CD8:EM
TCCCATGGTGAATATG	L:T:CD8:Naive
TCTGTCGGTGTCATTG	L:NK
TCTTGCGCAATGCAAA	L:T:CD8:EMRA
TGATTCTGTTCTCCCA	L:T:CD4:Naive
TGGGAGAGTTCGCGTG	L:T:CD4:Naive
TGGGCGTGTCACAGAG	L:T:CD4:CM
TGGTGATAGTGGTCAG	L:T:CD8:Naive
TTCTAACAGTCATGGG	L:T:CD8:EMRA
TTGACCCCAGTTGAAA	L:NK
TTTACGTAGAAATGGG	L:T:CD4:Naive
AACCATGTCCGCCTAT	L:T:CD8:Naive
AACCCAAGTGTGTACT	L:T:CD4:Naive
AACGGGATCCGATCTC	L:T:CD4:CM
AAGAACACATACACCA	L:T:CD4:CM
AAGATAGCACGGTGTC	L:T:CD4:CM
ACAACCACACGGTGCT	L:T:CD8:CM
ACAAGCTTCAAGTCGT	L:T:CD8:EMRA
ACATCCCTCCAAATGC	L:T:CD8:EMRA
ACCAAACTCTAAGGAA	L:T:CD8:EMRA
ACGGAAGTCACAATGC	L:T:CD8:EMRA
ACGTACACAATAAGGT	L:T:CD8:Naive
ACGTACAGTAGTATAG	L:T:CD4:Naive
ACTATCTTCGCATAGT	CD34
ACTATGGCAACCACAT	L:T:CD4:Naive
AGACCATGTGAGGCAT	L:T:CD4:CM
AGACCCGGTGAGTAGC	L:T:CD8:EM
AGACTCATCGACTCCT	L:T:CD4:Naive
AGATCCACATGTGACT	L:T:CD8:EMRA
AGGACTTAGGGTCACA	L:T:CD4:CM
AGTCAACGTGTCACAT	L:T:CD8:EMRA
AGTGACTGTAGCTTGT	L:T:CD4:Naive
AGTTAGCGTTCCAGGC	L:T:CD8:EMRA
ATCCACCAGTTAGAAC	L:T:CD4:Naive
ATCGATGAGTAGACCG	L:NK
ATCTTCAAGGCTTAAA	L:T:CD8:EMRA
CACTGTCTCGTTGTAG	L:T:CD4:Naive
CAGATCAGTACTGGGA	L:T:CD8:EMRA
CATGAGTTCTTAGCTT	L:T:CD8:EMRA
CATTCCGCATACACCA	L:T:CD8:EMRA
CATTCTAAGAGAGCCT	L:T:CD8:EM
CATTGAGCAGAGGAAA	L:T:CD4:CM
CCCTCTCTCGTCAAAC	L:T:CD4:CM
CCCTGATAGGAGTATT	L:T:CD8:EM
CCGTAGGAGGAGAATG	L:T:CD4:Naive
CGCATAACATGGACAG	L:T:CD8:EMRA
CGCGTGATCCCTGTTG	L:T:CD4:CM
CTAACCCAGGTGCCTC	L:T:CD4:CM
CTAGACAAGCGAGGAG	L:T:CD4:Naive
CTCATTAAGCGCTGCT	L:T:CD8:EM
CTCCATGTCAACGCTA	L:T:CD4:CM
CTCCCTCTCTGTACAG	L:T:CD8:EMRA
CTGCCTAGTAGAATGT	L:T:CD4:EM
CTGCGAGTCTGGTTGA	L:T:CD8:EMRA
CTGGTCTGTATCTCGA	L:B
GAACGTTTCTGGGCGT	L:T:CD8:Naive
GAAGCCCAGCTGTCCG	L:T:CD4:Naive
GAATCGTCAACTCGAT	L:T:CD4:CM
GACTCAACACTCCGGA	L:T:CD4:CM
GATCCCTGTTTCCCAC	L:T:CD8:Naive
GATGAGGAGAGCTGCA	L:T:CD8:Naive
GATGGAGAGTGCCGAA	L:T:CD8:EMRA
GATTCTTCAAGATCCT	L:T:CD4:CM
GCAACATTCCCGTTCA	L:T:CD4:EM
GCAGCCACATGTTACG	L:T:CD4:Naive
GCCCGAACACACTGGC	L:T:CD8:EM
GCGGATCTCACGTAGT	L:T:CD4:CM
GGAGCAAGTCGGATTT	L:NK
GGTAATCAGGTTGCCC	CD34
GTAGCTAAGCATTTGC	L:T:CD8:EMRA
GTGGTTAGTGAGGCAT	L:B:PC
GTTCGCTCAATCCTAG	L:T:CD4:Naive
GTTGCGGCAGCACGAA	L:T:CD4:EM
TAACTTCAGCTTTGTG	L:T:CD8:EMRA
TAGACTGGTCGATTAC	L:T:CD4:CM
TATGTTCTCAACTTTC	L:NK
TCAGGTAAGTCATGCT	L:T:CD4:Naive
TCCACGTAGGCCTAAG	L:NK
TCCACGTAGTACTCGT	L:T:CD8:EMRA
TGCAGATTCCTCTCGA	L:T:CD8:EM
TGTCCACGTTGCGGAA	L:T:CD8:EM
TGTTCATTCTGTACAG	L:T:CD4:CM
TTTGGAGAGATCACCT	L:T:CD4:CM
AACAAAGTCGGCTGTG	L:T:CD8:EMRA
AACAAGATCAAATGCC	L:T:CD4:Naive
AAGACTCGTTTCGACA	L:T:CD4:CM
AAGCATCCAAAGACTA	L:T:CD4:CM
AAGCGTTGTCTGATCA	L:T:CD4:CM
AAGGAATTCCTCTCTT	L:T:CD8:Naive
AATGACCAGAAAGTCT	L:T:CD4:CM
AATTTCCTCGTCGATA	L:T:CD4:Naive
ACAACCACACACGGTC	L:T:CD4:Naive
ACAAGCTTCACTTGGA	L:T:CD4:Naive
ACCAAACCACTCCGAG	L:T:CD4:CM
ACGCACGCATAGAGGC	L:T:CD4:EM
ACTTAGGAGAACGCGT	L:T:CD8:EMRA
ACTTATCAGGATCATA	L:T:CD4:CM
AGTAACCTCACCCTCA	L:T:CD8:EM
AGTGCCGAGTGGTTGG	L:NK
ATCCATTAGTGGAATT	L:T:CD8:Naive
ATCCATTGTTGCGAAG	L:B
ATGAGTCAGGTAAGAG	L:T:CD4:Naive
ATTCACTTCTCACCCA	L:T:CD8:EMRA
ATTCCCGGTGATATAG	L:T:CD8:EMRA
CAAGAGGGTCCTCAGG	L:T:CD4:CM
CAGCAATAGAGCCGTA	L:NK
CAGCACGGTTTGTGGT	L:T:CD4:Naive
CAGGCCAGTAGTACGG	L:T:CD4:Naive
CAGGGCTAGCCATGCC	L:T:CD8:EM
CATGAGTAGGACAACC	L:NK
CATGCGGAGCACTCAT	L:T:CD4:EM
CATTGTTGTCACAATC	L:NK
CCGTTCACACAATGTC	L:T:CD4:Naive
CGCCATTAGATAACGT	L:T:CD8:EMRA
CTACCCACAAACTAGA	L:T:CD8:Naive
CTGCCATTCATTGCTT	L:T:CD8:EMRA
CTGCGAGTCTTCGACC	L:T:CD8:CM
CTGGACGTCCTACACC	L:T:CD8:EMRA
CTGTGAATCGGATTAC	L:T:CD8:EM
CTTAGGATCCGATGTA	L:T:CD8:EMRA
GAAGTAAGTGGCCTCA	L:T:CD4:CM
GAATAGAGTATGGAAT	L:T:CD4:Naive
GATCACATCAACGCTA	L:T:CD4:CM
GATTGGTGTGATTCTG	L:T:CD8:Naive
GCACATACAGCCGTCA	L:T:CD4:CM
GCATCGGCAATCTCGA	L:T:CD4:CM
GCTGAATAGGGCAGTT	L:T:CD8:EMRA
GGAATCTAGATTGGGC	L:T:CD8:EMRA
GGCACGTTCCATGAGT	L:T:CD4:Naive
GGGCTACTCAAGCCCG	L:T:CD4:CM
GGGCTCAGTCTACATG	L:T:CD8:EMRA
GGGTGTCTCTTTCCGG	L:T:CD8:EMRA
GTAACACGTCAGCTTA	L:T:CD4:Naive
GTAGAAACATCAGCTA	L:T:CD8:EM
GTGAGTTGTAACTAAG	L:NK
GTGCAGCCAACTGTGT	L:T:CD8:EMRA
GTGGAGATCTTAATCC	L:T:CD4:CM
TATTCCAGTGCTTATG	L:T:CD8:EMRA
TATTGCTCACTACTTT	L:T:CD4:Naive
TCAGGTATCACCGGGT	L:T:CD8:EMRA
TCATTCATCCATTGCC	L:T:CD4:EM
TCCCACACAATCTAGC	L:T:CD8:EMRA
TCCCATGAGTCAATCC	L:T:CD4:CM
TCCGATCTCTCGCCTA	L:NK
TCCGGGAAGCAATAAC	L:T:CD4:CM
TCCTAATAGTTGAATG	L:T:CD8:EMRA
TCCTCGACAGTCAGAG	CD34
TCGCTTGCACATAACC	L:T:CD4:CM
TCTTGCGAGGCCTTCG	L:B:PC
TGAGTCATCAATCGGT	L:T:CD4:CM
TGCGGGTTCTGGCCTT	L:T:CD4:Naive
TGGATGTGTCGTACAT	L:T:CD4:Naive
TGTAGACTCTGCCCTA	L:NK
TGTTTGTGTCCTTGTC	L:B:PC
TTGACCCTCTCAGAAC	L:T:CD8:EMRA
TTGGGTACATCTCCCA	L:T:CD4:CM
TTTCAGTAGTTGGGAC	L:NK
TTTCAGTTCATCACTT	L:T:CD8:EMRA
AAATGGAGTGGTACAG	L:T:CD4:Tfh
AACCATGTCTTTCCGG	L:T:CD4:CM
AAGACAAAGACCTCCG	L:T:CD4:Naive
AAGCATCAGGATACAT	L:T:CD4:Naive
ACAGCCGAGATGCTTC	L:T:CD4:Naive
ACATTTCAGCTGACTT	L:T:CD8:Naive
ACCCTTGAGACCAACG	L:T:CD4:Naive
ACGTAACCACTGGAAG	L:T:CD8:EM
ACTATTCTCGATTGGT	L:T:CD4:Naive
AGACAAACAAGACTGG	L:T:CD8:EMRA
AGACACTGTTGTAAAG	L:T:CD4:Naive
AGGAAATAGTAGCCAG	L:T:CD8:EMRA
AGGCTGCTCACTGGTA	L:T:CD8:EMRA
AGGGTGAGTAGCTTGT	L:T:CD4:CM
AGTTCCCCACGTGTGC	L:T:CD4:Naive
ATACTTCTCAAGAGTA	L:NK
ATCAGGTAGTCATGCT	L:B:PC
ATCAGGTCAACAACAA	L:B:PC
ATGAAAGGTGTCCTAA	L:T:CD8:EMRA
ATGCATGTCTGCGGCA	L:NK
ATTATCCCACACGGTC	L:T:CD4:CM
ATTCAGGCAGAACTTC	L:NK
CAATACGTCAGACATC	L:NK
CACAACATCCTACACC	L:T:CD4:EM
CACATGAGTTAAGAAC	L:T:CD4:EM
CACCGTTAGTGATGGC	L:T:CD4:EM
CACTGAAAGTCGGGAT	L:T:CD4:CM
CAGATACAGCCTATCA	L:T:CD8:Naive
CAGTTAGGTTGCTTGA	L:NK
CATGAGTGTAGGAAAG	L:T:CD8:EMRA
CATTTCACAACGTATC	L:NK
CCAATGAAGTTGCATC	L:T:CD4:CM
CCCAACTGTAGGAAAG	L:T:CD8:EMRA
CGAATTGTCACAAGAA	L:T:CD8:EM
CGATCGGTCATTCGTT	L:T:CD4:Naive
CTAACCCAGGTAAGTT	L:T:CD8:EMRA
CTGCATCCATGGAGAC	L:T:CD8:EM
CTGCATCTCCGAAGGA	L:T:CD8:Naive
CTTCTAACAGGCTACC	L:NK
GAAGCCCTCTCCGAGG	L:NK
GACCCTTCACGGCGTT	L:NK
GAGCCTGTCTCTTGCG	L:T:CD8:Naive
GAGTGAGTCGCATAGT	L:T:CD4:Naive
GAGTGTTCATGTTCAG	L:T:CD8:EM
GATCAGTTCTGCGGCA	L:T:CD8:Naive
GATTTCTCAGAGTGAC	L:T:CD8:EM
GCATGATGTTGGTACT	L:T:CD4:EM
GCGGAAAAGTCGGGAT	L:T:CD4:CM
GCTGGGTGTGCCGTTG	L:T:CD8:EMRA
GGGCCATCATTGAAGA	L:T:CD4:CM
GGGCTACGTCCGGCAT	L:T:CD4:CM
GTAACCAAGTCTACCA	L:T:CD4:CM
GTACAGTGTATGTGTC	L:T:CD4:CM
GTGAGTTGTTACGGAG	L:T:CD8:Naive
GTGATGTCACAGTCGC	L:T:CD4:CM
GTTCTATAGAGGTATT	L:NK
TACAGGTAGGTGAGAA	L:T:CD4:Naive
TACCTGCCAACGTAAA	L:T:CD8:EMRA
TAGCACAGTAGTTCCA	L:NK
TATCTGTAGCTACTAC	L:T:CD4:CM
TATGTTCCATGTTCAG	L:NK
TATTGGGCAATAGGGC	L:T:CD4:Naive
TCAAGTGCAACCGATT	L:T:CD8:EM
TGACCCTAGGACTGGT	L:T:CD4:CM
TGATGGTTCATGGTAC	L:T:CD4:CM
TGCGGGTTCTATCGGA	L:T:CD4:Naive
TGCTCCAAGATTCGCT	L:T:CD4:Naive
TGTGCGGCATAACCCA	L:T:CD8:EM
TTACGCCAGGATTTGA	L:T:CD8:EM
TTCAATCGTGTTCCTC	L:T:CD8:EMRA
TTCCGGTGTGGGCTTC	L:T:CD8:EMRA
TTCTAGTAGTACCATC	L:T:CD4:CM
TTGGGCGGTTGGACCC	L:T:CD4:Naive
TTTACCATCTAGGCCG	L:NK
AAAGGATGTCACCACG	L:T:CD8:Naive
AAAGGTACATTGACCA	L:NK
ACAGGGAAGGGCCCTT	L:T:CD4:CM
ACCGTTCGTTGCTCGG	L:T:CD4:Tfh
ACTGTGAGTGTTCGTA	L:T:CD4:CM
AGCGCTGAGCTTGTTG	L:NK
AGGAAATGTTCATCTT	L:T:CD4:Naive
AGGGTCCAGCGGGTAT	L:T:CD4:CM
AGGTCTATCCTAACAG	L:T:CD4:Naive
AGTGCCGTCTTTGCTA	L:T:CD4:Naive
AGTTCCCTCCCAAGCG	L:T:CD4:EM
ATGGAGGGTTAGGGTG	L:NK
ATGGGAGAGTGAGTTA	L:T:CD4:Naive
ATGGGAGTCTATCCAT	L:T:CD4:CM
CAACGATCACACAGAG	L:T:CD4:Naive
CAATCGAGTCAAACGG	L:NK
CAATCGAGTGCTAGCC	L:T:CD4:Naive
CACTGAATCACCCTCA	L:T:CD4:CM
CAGCAGCCAGACCGCT	L:T:CD4:CM
CATACTTGTTGCATAC	L:T:CD4:CM
CATTCCGAGGTAAACT	L:T:CD4:CM
CCTCCAATCTCGACGG	L:T:CD4:CM
CCTTCAGAGGGCTTCC	L:T:CD4:Naive
CGCATAAGTCCTACGG	L:T:CD4:CM
CGTCCATAGTCTACCA	L:T:CD4:CM
CTAGACATCTCTATAC	L:T:CD4:CM
CTATCCGAGTCGCTAT	L:T:CD4:Naive
GAAGGACGTGGGATTG	L:T:CD4:Treg
GACCAATAGGGCAGAG	L:T:CD4:Naive
GATGACTGTTGGGACA	L:T:CD8:EMRA
GCAACATGTTGTACGT	L:NK
GGGCTACTCTCTGAGA	L:T:CD4:Naive
GGGTGAATCAATGCAC	L:T:CD4:CM
GGTAATCCAGGCTCTG	L:T:CD8:EMRA
GTGTCCTCAATGTCTG	L:T:CD4:Naive
GTGTGATCATGACAGG	L:T:CD8:CM
GTTCGCTAGATGCCGA	L:B:PC
TAGGGTTGTCTGCATA	L:T:CD4:Naive
TAGGTACTCCCAACTC	L:T:CD8:EMRA
TAGTGCATCATAGACC	L:NK
TCACAAGCATGTTACG	L:T:CD4:CM
TCCGAAATCAGGTGTT	L:T:CD4:Naive
TCCGAAATCCTAGCGG	L:T:CD4:Naive
TCTAACTCACTCTGCT	L:B:PC
TGAGGTTTCGAGTACT	L:T:CD4:Naive
TGGAGGATCGGACTGC	L:T:CD4:CM
TGTGTGAAGCCTTGAT	L:T:CD8:EMRA
TTAGTCTGTCTAACTG	L:NK
TTCCGTGGTAGGTACG	L:T:CD8:EMRA
TTGGATGAGCGGCTCT	L:T:CD8:Naive
TTGTTTGGTGGTCTGC	L:T:CD4:CM
TTTATGCAGTCATACC	L:T:CD8:EMRA
TTTCCTCTCGTGGTAT	L:NK
AAAGGATCATCAACCA	L:T:CD8:EMRA
AAGCCATGTTAGGAGC	L:T:CD8:EMRA
ACCATTTGTACGGCAA	L:T:CD8:EMRA
ACGATGTCAAGTGGCA	L:T:CD8:Naive
ACTTAGGAGCGAGTCA	L:T:CD4:CM
AGAACAAAGTGGAAAG	L:T:CD8:Naive
AGAGCCCGTGATGAAT	L:T:CD4:CM
AGCGCCATCGCTACAA	L:T:CD4:CM
AGGGTTTAGAAGATCT	L:T:CD4:CM
AGGTGTTTCACCCTTG	L:T:CD8:EMRA
AGGTGTTTCTGACAGT	L:T:CD8:EMRA
AGTAACCGTTTCTTAC	L:T:CD4:CM
AGTAACCTCATGTCAG	L:B:PC
AGTCAACCACTGTGTA	L:T:CD4:EM
ATAGACCTCTCGCTTG	L:T:CD4:Treg
ATCACTTAGTCTTCGA	L:T:CD4:CM
ATTCCATCAACGAGGT	L:T:CD4:CM
ATTTCACCACCTATCC	L:T:CD4:Naive
CAAGCTAGTAGATCCT	L:NK
CAATGACTCTGGACTA	L:T:CD4:Naive
CACGGGTCATGACTCA	L:T:CD4:CM
CATTGAGCATGTGGTT	L:T:CD4:Naive
CCATCACTCATGACAC	L:T:CD8:EM
CCCGAAGCAAAGAGTT	L:T:CD8:EMRA
CCGGTAGCAGCAGACA	L:T:CD4:CM
CCGTTCAAGAGTGTGC	L:NK
CGGAACCTCTATCCAT	L:T:CD8:CM
CTACTATTCCGAAATC	L:T:CD4:Naive
CTCCTTTGTTAGAGTA	L:T:CD4:Naive
CTGCAGGGTTTACTGG	L:T:CD8:EMRA
CTGTACCCAAGGCGTA	L:T:CD4:CM
CTGTATTCAGAACTCT	L:T:CD8:EMRA
CTTGATTGTGGGACAT	L:T:CD4:CM
GAGCTGCCATTGGCAT	L:T:CD8:EMRA
GAGTCATAGTCGAATA	L:T:CD4:Naive
GATCACATCTGGCCAG	M:Mega
GATCCCTTCATCGTAG	L:NK
GATGCTAAGGCATTTC	L:T:CD8:EMRA
GATGGAGTCATGTCAG	L:T:CD8:EMRA
GCACATACAACACGAG	L:NK
GGGACAACAATGAACA	L:T:CD4:CM
GGGAGTATCGATGCTA	L:T:CD4:EM
GGTCTGGCAGACTCTA	L:B:PC
GTATTTCAGCTGAAGC	L:T:CD8:Naive
GTGAGCCCAAGTAGTA	L:T:CD8:EMRA
TACAGGTCATTGTAGC	L:T:CD4:CM
TACATTCGTAACTGCT	L:T:CD4:CM
TACGGTAAGGAACGCT	L:T:CD4:CM
TAGACCAGTATCAGCT	L:T:CD4:CM
TAGGTTGAGGCTTTCA	L:T:CD8:EM
TCAATTCAGAGCCTGA	L:T:CD8:EMRA
TCAGTCCGTTCACGAT	L:T:CD4:EM
TCCTTCTCAGCGTGCT	L:NK
TGTGAGTCAGCCTTCT	L:T:CD4:CM
TTCCTCTTCGTCCTTG	L:T:CD8:EMRA
TTTACCACACATTACG	L:T:CD4:Naive
TTTGATCTCAGCATTG	L:T:CD4:Naive
AAAGGATCATGTCGTA	L:T:CD4:EM
AAAGTGAAGTGATAAC	L:T:CD8:Naive
AACAAAGCAATTAGGA	L:NK
AACAGGGCAGCTGGTC	L:T:CD4:EM
AAGCCATCATTACGGT	L:T:CD4:Naive
ACGGAAGTCATTCCTA	L:T:CD4:CM
ACTTAGGGTCTCGGAC	L:T:CD4:CM
AGCTTCCAGTCGAATA	L:T:CD8:Naive
AGGCCACTCTTAGCAG	L:T:CD4:CM
AGGGCCTCACGTGAGA	L:B:PC
AGTCATGCAACACGTT	L:T:CD4:EM
ATACTTCCAGACACAG	L:NK
ATGCCTCTCGAAGAAT	L:T:CD8:EM
ATTCCCGTCCATGATG	L:T:CD4:Naive
CACACAAGTAGGTGCA	L:B
CATGCTCTCGAGCTGC	L:T:CD8:EMRA
CCACGTTTCACTAGCA	L:T:CD8:EMRA
CCCTAACTCGCTGATA	L:B:PC
CCGGTAGTCTCGCTTG	L:NK
CTACATTAGAGTTGAT	L:T:CD4:CM
CTAGACACAGCATGCC	L:T:CD8:Naive
CTCAGGGAGGTAGCCA	L:T:CD4:CM
CTGTACCGTATGTGTC	L:T:CD4:CM
GAGTCTATCTCAGGCG	L:T:CD8:EMRA
GCAGGCTTCAAGTTGC	M:Mega
GCCCAGACATGAGAAT	L:T:CD4:Naive
GCTTCACAGTAGACAT	L:NK
GGAATGGTCCTACGAA	L:T:CD4:Naive
GGGACAACATGATGCT	L:T:CD8:EMRA
GGGTGTCGTACTTCCC	L:NK
GGTTGTACACACGTGC	L:T:CD8:EMRA
GTGGGAAGTACCAGAG	L:T:CD4:CM
GTGTTCCCAAGGAGTC	L:T:CD4:CM
GTTGTGACATATAGCC	L:T:CD4:Naive
TACTTGTGTCCCAAAT	L:T:CD4:Naive
TAGCACAAGGGCATGT	L:T:CD4:CM
TAGGAGGTCAGTCATG	L:T:CD8:EMRA
TCACGGGGTTCTCAGA	L:NK
TCAGCAATCCAAACCA	L:T:CD8:EM
TCATCATGTGTTAAAG	L:B:PC
TCATCCGTCATTGGTG	L:T:CD4:Naive
TGAGACTGTGGTCTAT	L:T:CD4:EM
TGTACAGCACTCATAG	L:B:PC
TTACTGTGTCCAGGTC	L:T:CD4:EM
TTAGTCTAGTTGAATG	L:T:CD4:CM
TTCATTGCATTCTCCG	L:T:CD8:EMRA
TTCTAACCAACCAATC	L:T:CD8:EMRA
TTTATGCAGCGGGTAT	L:T:CD8:EM
AACCATGCATCAGTGT	L:T:CD8:EMRA
ACAGCCGAGTCATGGG	L:T:CD8:CM
ACCACAAGTAGGATAT	L:T:CD8:Naive
ACCCAAATCGTTCAGA	L:NK
ACTGCAACAGACCAGA	L:T:CD4:CM
ACTTTCAAGGGTACAC	L:T:CD8:EM
AGGCCACTCTACGCAA	L:NK
AGGGTGATCGTGGGTC	L:T:CD4:Naive
AGTGATCTCCCATGGG	L:T:CD4:CM
ATCCACCAGGCACGAT	L:B:PC
ATTCATCAGGCCTAGA	L:T:CD8:EMRA
CAACGGCAGTAGAATC	L:B
CACAGATTCTGGGTCG	L:B:PC
CAGCACGGTGTCACAT	L:T:CD4:CM
CAGTTCCCATACAGAA	L:T:CD4:Naive
CCCGGAATCGTTCCCA	L:T:CD8:EM
CCGGTGACACACAGAG	L:T:CD4:CM
CCTCAACTCACTACTT	L:T:CD4:Naive
CTCTCGAGTCCTGTTC	L:T:CD8:EMRA
CTGCAGGGTCACTCGG	L:T:CD8:EMRA
CTTCCGAGTCTGTTAG	L:T:CD4:CM
GACTGATAGAAACTGT	L:T:CD4:Tfh
GATCATGTCTGCTTTA	L:T:CD4:Naive
GGGACAATCTCAGAAC	L:T:CD8:EMRA
GGGCCATAGCGAATGC	L:T:CD4:Naive
GGGCTACAGTGGATAT	L:T:CD8:EM
GGGTGTCAGATGATTG	L:T:CD4:CM
GTCAAACGTGATACCT	L:NK
GTGATGTGTCTCGCGA	L:T:CD4:Naive
GTTACCCAGTGCTAGG	L:T:CD4:CM
TAACTTCGTTGCTCAA	L:T:CD8:CM
TAGACCAAGTGCTACT	L:T:CD4:CM
TAGCACATCAGGACGA	L:T:CD4:Naive
TATTTCGGTACTGGGA	L:T:CD8:EMRA
TCAAGCACATAGAGGC	L:T:CD4:Tfh
TCAGCAAGTCTGATCA	L:T:CD8:EMRA
TCTACCGAGATTCGCT	L:T:CD8:Naive
TCTGGCTTCAGGTAAA	L:T:CD4:CM
TGACTCCTCAGGAGAC	L:T:CD4:CM
TGACTCCTCTCTCAAT	L:T:CD4:Naive
TGATTCTGTTGGATCT	L:NK
TGCTGAATCGCCAACG	L:T:CD4:CM
TGCTTGCGTTCTCTCG	L:NK
TTAGTCTTCGGCTGTG	L:T:CD4:CM
TTATTGCCAAATTGCC	L:T:CD8:CM
TTGCCTGGTGCCCACA	L:T:CD4:CM
TTTACTGTCCACTGGG	L:T:CD4:Naive
AAAGAACAGGTTCCGC	L:T:CD4:CM
AAGACTCCAATGCAGG	L:NK
AAGACTCTCAGCTTGA	L:T:CD4:CM
ACATGCACAGCAGGAT	L:T:CD8:EMRA
ACTCTCGCAAGGTTGG	L:T:CD4:CM
AGAAGCGCAGAACATA	L:T:CD4:Naive
AGAAGTACAAGTTGGG	L:T:CD8:EMRA
ATAGAGACATCATCCC	L:T:CD8:EM
ATCAGGTCATAGTCAC	L:T:CD4:CM
ATGAAAGCACTGCGAC	L:T:CD4:CM
ATGTCTTTCACTCACC	L:NK
ATTCTACCACTACCCT	L:NK
CACAACACACCGTCTT	L:T:CD4:Naive
CACAGGCGTACCAATC	L:T:CD8:EMRA
CACATGACAATTTCTC	L:T:CD4:CM
CATGGATTCTGTCGTC	L:T:CD4:Tfh
CATTTCAAGGCCTAAG	L:T:CD8:EMRA
CCACTTGTCAACGCTA	L:T:CD4:Naive
CTCATCGAGCACTCCG	L:T:CD8:EMRA
CTGGACGTCATCACTT	L:T:CD4:Naive
CTGGTCTAGCACTAGG	L:T:CD4:CM
GACCAATCACGCTGTG	L:T:CD4:Naive
GACTATGGTTATGTCG	L:T:CD8:EMRA
GAGGGATCATTGACAC	L:T:CD8:Naive
GAGGGTACAGTTTCGA	L:NK
GATCGTACATAGCACT	L:T:CD4:EM
GCATCTCCATGTGCTA	L:T:CD4:CM
GCTACCTAGAGCAAGA	L:T:CD8:EMRA
GGGACAATCGTAGAGG	L:T:CD4:Naive
GTGGAGAAGTCTAGCT	L:T:CD8:EMRA
TAACTTCAGCCTCTCT	L:NK
TAATCTCTCGAACGGA	L:T:CD8:EMRA
TACCGAACACTCAGAT	L:NK
TATACCTAGATGAAGG	L:T:CD8:EMRA
TATACCTCACTGGAAG	L:NK
TCATACTAGTCACTGT	L:T:CD4:CM
TGACAGTCACATAGCT	L:T:CD8:EMRA
TGGATCACATGTAACC	L:T:CD8:Naive
TGGCGTGCAGAAATTG	L:NK
TTCCGTGAGAGCAAGA	L:T:CD8:Naive
TTGGGCGGTTCAGGTT	L:B:PC
AAATGGATCCTTGACC	L:T:CD4:CM
AACTTCTGTAAGGTCG	L:T:CD8:Naive
AAGAACAAGCCTCATA	L:NK
AATCGTGCACGCTGCA	L:T:CD4:Naive
ACAAGCTGTTGTAGCT	L:T:CD8:EMRA
ACCTGTCTCCTGGGTG	L:T:CD8:EMRA
ACGGGTCAGCGGTAGT	L:T:CD8:EMRA
AGAAGTACAGCGTTTA	L:NK
AGACACTAGTCCCAAT	L:T:CD8:EMRA
AGACAGGTCTTACGTT	L:T:CD8:Naive
AGCCACGCATGGGATG	L:T:CD4:CM
AGCGCTGAGACCTCCG	L:T:CD8:EMRA
AGGTTACAGTATCTGC	L:T:CD4:Naive
ATGACCACACCAAATC	L:T:CD4:CM
ATGCATGGTCTAGGTT	L:T:CD8:EMRA
ATGGAGGCAACCCTCT	L:T:CD4:CM
ATTACCTAGCCTCTTC	L:T:CD8:EMRA
CAATGACTCTGAGTCA	L:T:CD8:EMRA
CACGAATCAGTTGTCA	L:T:CD8:EMRA
CACTAAGAGTGACACG	L:NK
CACTGGGAGGGTACAC	L:NK
CCCGGAACAAGTGCAG	L:T:CD8:EMRA
CCTCACATCAAGGCTT	L:T:CD4:CM
CTAGACAAGTGTGTTC	L:T:CD4:Naive
CTCACTGGTTCTCTCG	L:NK
CTGGTCTAGTAGGCCA	L:NK
CTGTACCTCTCAACGA	L:T:CD4:CM
GAACACTCAAAGAGTT	L:B:PC
GAACGTTGTCTACGTA	L:T:CD4:CM
GATAGAATCGACACTA	L:T:CD4:CM
GCATGATTCAACACCA	L:T:CD4:Naive
GGATGTTTCATTCGGA	M:Mega
GGGATCCCACATATGC	L:T:CD8:EMRA
GTAGGAGTCTCTCAAT	L:T:CD4:CM
GTAGTACCATTACTCT	L:T:CD4:Naive
GTGCACGAGGGAGTTC	L:NK
GTTATGGCATGGATCT	L:T:CD8:EMRA
TAATCTCTCCGTGTCT	L:T:CD4:CM
TAGGGTTCATTCCTCG	L:T:CD8:EMRA
TAGGGTTGTGAAAGTT	L:B:PC
TATCTTGCAAACTAAG	L:T:CD8:EMRA
TGTCCTGAGTTCACTG	L:T:CD8:EMRA
TTCAATCCAGTCAACT	L:NK
TTGACCCCAAGGAGTC	L:NK
TTTAGTCCACAAGCAG	L:B:PC
AAGCCATAGTGATTCC	L:T:CD8:EMRA
AATGACCAGCCAGACA	L:B:PC
ACAACCAGTAGAGATT	L:NK
ACCTGAACACTAGGCC	L:T:CD8:EMRA
AGAGCAGTCATTACCT	L:T:CD8:EMRA
AGCGCTGTCGTGAGAG	L:NK
AGGAGGTTCAAGTGGG	L:T:CD8:EMRA
AGTCATGAGCACCAGA	L:T:CD4:CM
ATGGATCGTTAGAGAT	L:T:CD8:EMRA
ATGGGTTCACCCTGAG	L:NK
CAGTTAGTCACTGCTC	L:T:CD8:EM
CCTCATGCACGGCTAC	L:T:CD4:Naive
CGGAACCTCCATACTT	L:NK
CTCCAACGTCCAATCA	L:NK
CTGCCATCATCTTCGC	L:T:CD4:Naive
CTGTCGTAGATGCTGG	L:NK
CTTCAATAGGCATCAG	L:T:CD8:EMRA
CTTCCTTGTAGTCTTG	L:T:CD4:CM
GACACGCTCGAGTGAG	L:T:CD8:EMRA
GACTCTCAGATGCCGA	L:T:CD4:CM
GAGGCAAAGAGTGTTA	L:B:PC
GCACGTGCAGTAACCT	L:T:CD8:EMRA
GCAGCTGCACGGCTAC	L:T:CD4:CM
GCCAGTGCAGATTTCG	L:T:CD8:EMRA
GCCCAGAAGAACAAGG	L:T:CD4:EM
GCTGGGTAGAGCAGTC	L:NK
GGTGTCGCACTACGGC	L:T:CD4:CM
GTAGGAGGTCACCCTT	L:T:CD4:CM
TACAGGTAGGGCCAAT	L:T:CD8:EM
TCAATCTTCTAGCATG	L:T:CD4:Naive
TCACAAGAGCTAATGA	L:T:CD8:EMRA
TCCTGCACACGGTCTG	L:NK
TCGCTCACACACGTGC	L:NK
TGAGTCAAGCAACCAG	L:T:CD8:EMRA
TGCAGATGTTAAAGTG	L:T:CD8:EMRA
TTGAGTGTCCACTGAA	L:T:CD8:EMRA
AAGCGAGTCTCCCAAC	L:B:PC
AAGTGAAAGTAAACTG	L:T:CD8:EMRA
ACTATCTAGCTCGAAG	L:NK
ATCACAGTCGTTCATT	L:NK
ATCGGATTCGAACCTA	L:T:CD4:CM
ATCTTCATCATCACAG	L:T:CD4:CM
CATGGTACATGAAGGC	L:NK
CCACAAATCAAGCCTA	L:T:CD8:EMRA
CCGGACACAGAGTGAC	L:T:CD8:Naive
CGAAGGATCCACGGGT	L:T:CD4:CM
CTCATTAGTAGGTGCA	L:NK
CTCCGATGTAGGATAT	L:NK
CTGTACCTCTCGACCT	L:T:CD4:Naive
GAGGGTAGTCCGACGT	M:Mega
GATCGTACAAATAAGC	L:NK
GGAGAACTCCCTCTAG	L:T:CD4:CM
GGTAACTTCTAAGGAA	L:NK
TCACGCTAGCTTTGTG	L:NK
TCATATCAGCGTATGG	L:T:CD8:EMRA
TCATCATTCTAGCCAA	L:T:CD4:CM
TCCACGTTCCGAGCTG	L:NK
TGATCAGGTAGGTAGC	CD34
TGCGATATCGCCACTT	L:T:CD4:CM
TGGTAGTCATAGGTAA	L:T:CD8:EM
TTCTAGTTCATTGTGG	L:T:CD8:EM
AAGACAAGTGCATCTA	L:T:CD8:EMRA
AAGCATCCACACCTTC	L:T:CD4:CM
ACGGGTCTCAAATGAG	L:T:CD4:Naive
ATGAGGGGTGATACTC	L:T:CD8:EMRA
ATTCGTTCAAACAGGC	L:T:CD8:CM
ATTCTTGTCAAACTGC	L:T:CD4:CM
CAAGCTAGTCTGATAC	L:NK
CAGCCAGAGAGCGACT	L:NK
CCTCATGTCTGGTTGA	L:T:CD4:Naive
GAATCACAGTTTAGGA	L:NK
GATGGAGTCCATCACC	L:T:CD4:CM
GGAGAACAGTTGGGAC	L:T:CD8:EMRA
GGGTTTACATGATCTG	L:T:CD8:EMRA
GTCGAATTCAATCTTC	L:NK
GTGAGGAAGACCACGA	CD34
TAAGCCAAGGATGAGA	L:T:CD8:Naive
TCACACCCAAATTGGA	L:T:CD8:EMRA
TCGAAGTCACCAAATC	L:NK
TCTATCACATGCCGGT	L:T:CD4:Naive
TGGATGTTCTTGGTGA	L:T:CD4:CM
TTGCATTCATGTTACG	L:NK
ACACGCGAGCATTGAA	L:T:CD4:CM
AGAGCAGGTGTGTTTG	L:T:CD4:Naive
ATGAAAGGTTCCGTTC	L:T:CD4:Naive
CAAAGAAAGAAGCTGC	L:T:CD4:EM
CCCATTGGTAGGCAAC	L:NK
CGGGTCAAGGATTTGA	L:NK
CTCGAGGGTCCTGTCT	L:NK
CTGGTCTAGGCTAACG	L:NK
GACTCTCGTACTCGTA	L:NK
GAGTTGTCACTTGTGA	L:T:CD4:EM
GGAGGTATCCTCTAGC	L:T:CD8:EMRA
GGCTTTCAGAGCCGAT	L:T:CD8:EM
GGTAACTCACTTGACA	L:T:CD4:CM
GGTTGTACAGCTGAAG	L:T:CD4:CM
GTGCGTGAGCATATGA	L:NK
GTGTCCTTCGGAAGGT	L:NK
GTTAGTGCATCACAGT	L:T:CD4:CM
TAGAGTCCAATAGGGC	L:T:CD4:CM
TATCAGGTCGCTCCTA	L:T:CD8:EM
TGAGGTTTCAACTTTC	L:T:CD4:CM
TGGGCTGCAGGTCAAG	L:T:CD4:Naive
TGGTGATTCTAGTACG	L:T:CD4:Naive
TGTCCCATCCGGTTCT	L:T:CD4:Naive
AACAGGGGTTCATCTT	L:NK
ACCATTTCACTCTAGA	L:NK
AGAGAATAGGACTGGT	L:T:CD8:EMRA
AGGATCTCAGTAACGG	L:T:CD8:EMRA
AGTCATGCACTAACCA	L:T:CD8:EM
ATCACTTTCCAACCGG	L:NK
ATGAGGGCACTATCCC	L:T:CD8:EMRA
CAAAGAAGTCGTACAT	L:T:CD8:EMRA
CCACGAGTCACTGTCC	L:T:CD4:Naive
CGTAGTAAGACCAGAC	L:NK
GAGCCTGCACTCTCGT	L:T:CD4:CM
GATCCCTGTGAGTTTC	L:B:PC
GGGTCTGTCGGCCCAA	L:T:CD8:EMRA
GGTTCTCTCATTACTC	L:T:CD4:Naive
TAACACGCAGATCCAT	L:T:CD4:CM
TAATCTCAGAAATTCG	L:NK
TCCTTCTTCCTACCAC	L:NK
TCTATCACACGGTGCT	L:T:CD8:Naive
TGTCAGAAGATTGTGA	L:T:CD8:EMRA
TGTTGGAGTTACACTG	L:T:CD4:Naive
TTTCACATCTCGTGAA	L:T:CD4:Naive
AATGGCTTCGATCCAA	L:T:CD8:EMRA
ACCTGAAGTATAGGGC	L:T:CD8:Naive
ACTGCAAAGGCGAAGG	L:B:PC
AGAACAAAGAAGTATC	L:T:CD4:EM
AGCTTCCTCTAGCATG	L:T:CD4:CM
AGGGCCTCAGCGGTTC	L:T:CD4:Naive
ATCCTATAGGATACGC	L:T:CD4:CM
CACGAATCACCTGTCT	L:T:CD8:EMRA
CAGATACTCTACACAG	L:T:CD4:Naive
CATAAGCAGCCTTTGA	L:NK
CCATCACTCCATTTAC	L:T:CD4:CM
CCGTGAGAGTCACAGG	L:NK
CTATCCGAGTGGTTGG	L:T:CD4:CM
CTGGTCTGTAGCCAGA	L:NK
CTTCTCTTCCCATGGG	L:T:CD4:CM
GAGAGGTGTCCACACG	L:NK
GTATTGGGTCCATCTC	L:NK
GTTCTATAGTTGCATC	L:T:CD8:EMRA
TCAAGACAGTTCATCG	L:NK
TCATGCCTCGTCAAAC	L:T:CD8:EM
TCATGTTTCTAGGCAT	L:NK
AAAGTCCAGTCTGGAG	L:NK
AACCTTTCAATAAGGT	L:NK
AAGATAGTCTTCGCTG	L:T:CD4:EM
ATCAGGTAGGAAGAAC	L:B:PC
ATCCGTCTCCCTTTGG	L:NK
CACTTCGCAATGGCAG	L:NK
CATACCCGTACAAGTA	L:T:CD4:Naive
CATGAGTCAATGAAAC	L:T:CD4:CM
CGGACACTCGCCATAA	L:T:CD4:EM
GATGATCGTATGCAAA	L:T:CD4:Naive
GCACTAATCTGCCTGT	L:T:CD8:EMRA
GCCCGAACAATGAAAC	L:T:CD8:Naive
GGGTAGATCCAGCCTT	L:NK
TAGAGTCAGTAGATCA	L:T:CD8:EMRA
TATCTGTCACGACAGA	L:NK
TCTGCCATCCCGTGAG	L:T:CD8:EMRA
TGCAGGCGTTTGTGGT	L:B:PC
TGCTCCACACTCATAG	L:NK
TGCTCGTAGGCTCAAG	L:NK
TGGTAGTGTGGCACTC	L:T:CD4:Naive
TTATTGCGTCTCCCTA	L:NK
TTCCGGTGTAGTCACT	L:NK
TTGGATGGTCGAATGG	L:T:CD4:CM
AGGATCTCAAGAGAGA	L:T:CD4:Naive
AGGATCTCAATCGTCA	L:NK
ATCGTAGCAGCAGTTT	L:T:CD8:Naive
ATGACCAAGGACGGAG	L:T:CD4:CM
ATGCCTCTCATGCGGC	L:T:CD4:CM
ATGGTTGAGTTGGCTT	L:T:CD4:EM
CCGAACGCAGACCTAT	L:T:CD8:EMRA
CGCCAGATCCGTGGCA	L:NK
CTTCGGTTCAAACGAA	L:T:CD8:EMRA
GATCAGTCAGTTGGTT	L:NK
GATTTCTCATGAAAGT	L:T:CD8:EMRA
GGGACAAAGCGGACAT	L:T:CD8:Naive
GTGATGTGTGGATCAG	L:NK
TACATTCAGTCTGCAT	L:T:CD8:EMRA
TCATCATTCGAAGTGG	L:T:CD8:EMRA
TGATGGTAGGCACGAT	L:NK
TGCGGGTCAGAGATTA	L:NK
TGTAGACTCGCTGTTC	L:NK
TGTTGAGTCATATGGC	L:NK
TTACGTTCAATAAGGT	L:NK
AACCAACAGAATTCAG	CD34
AACTTCTAGAATTGTG	L:T:CD4:EM
ACAAAGATCACCTCAC	L:T:CD4:CM
ACTGCAACAACTGCCG	L:T:CD4:CM
AGCCACGGTATCGCTA	L:NK
ATGATCGAGTCCTACA	L:NK
CATGGATTCAACGAGG	L:T:CD4:Naive
CCTCTAGTCCGACATA	L:NK
CTGTGAACAGCAGAAC	L:NK
GCCAGCAAGCGCCTAC	L:NK
GTCTCACTCCGTTTCG	L:T:CD8:EMRA
TACACCCAGCGATTCT	L:T:CD8:EMRA
TAGGAGGGTATCGTAC	L:T:CD4:Naive
TCTGGCTCAAATCAAG	L:T:CD4:EM
TGACGCGGTAACGTTC	L:NK
ATTCACTTCAGTAGGG	L:T:CD8:Naive
CTCAGAATCTTCGACC	L:T:CD8:EMRA
CTGATCCGTACTGAGG	L:T:CD8:EMRA
CTTACCGTCCCAATAG	L:NK
GAGCTGCAGACGCCCT	L:NK
GTGCACGAGCCGCTTG	L:NK
GTTCTATGTAACATGA	L:NK
TCTATCAAGGGTGAAA	L:B:PC
TGGAACTAGTATGGAT	L:T:CD8:EMRA
TTACCGCAGCACTTTG	L:T:CD4:CM
TTTACTGAGTTCTCTT	L:T:CD8:EMRA
TTTCACATCCAGTTCC	L:NK
ACAAAGAGTAACTAAG	L:T:CD4:CM
ACAACCAGTATGAGGC	L:NK
ACGTACACAGCAGTTT	L:T:CD4:Naive
ATGCGATCACAGTGTT	L:NK
CAGATACGTCTGTAGT	L:T:CD4:Naive
CCAATGAGTTGTCCCT	L:T:CD4:CM
CCGATGGTCTACTTCA	L:T:CD8:EMRA
CGAATTGTCATCCTAT	L:NK
GCAGTTATCGGAAGGT	L:T:CD8:EMRA
GCGTTTCCAGCTCGGT	L:NK
GGAATGGAGACCATAA	L:NK
GGACGTCCAGAACATA	L:NK
GTAGTACAGTAGGAAG	L:NK
GTGAGGATCATCCCGT	L:T:CD4:CM
GTGTTAGTCCTATTGT	L:NK
TACCGAATCACAACCA	L:T:CD4:Tfh
TCAAGCAGTGAGTTTC	L:T:CD8:EMRA
TCCAGAAAGCAGGGAG	L:NK
TGGCGTGTCCCTTCCC	L:NK
TTAATCCCATGTTCAG	L:T:CD8:Naive
TTGAACGCAACAGATA	L:NK
AAACCCAAGGGCTAAC	L:T:CD4:CM
ACAGCCGGTTGTCATG	L:T:CD4:CM
ACGGGTCTCCCTCATG	L:NK
ATCGTAGGTTAGTCGT	L:NK
ATGGATCTCACCTTAT	L:B:PC
ATTACCTAGATACCAA	L:NK
CCACTTGAGAGAGAAC	L:NK
GACCTTCGTAGGTGCA	L:NK
GATGGAGCAATCGCAT	L:T:CD8:EMRA
GCCATGGAGAGTCTTC	L:NK
GGGACTCTCATTTGTC	L:NK
GTGATGTGTTATCTTC	L:T:CD8:EMRA
GTGCGTGGTGTGTGTT	L:NK
TAAGCACGTAGCGTCC	L:NK
TACTGCCAGAAATGGG	L:NK
TCATTCAGTACGGCAA	L:B:PC
TCCGATCAGGGAGTTC	L:NK
AACACACCAAGTGGGT	L:NK
ACCCTTGAGTCCCGAC	L:NK
ACCTACCAGTATAACG	L:NK
ACTGTGACACGAAGAC	L:T:CD4:Naive
AGGGCCTCAGACATCT	L:T:CD8:EMRA
CACTGAAAGCAGGGAG	L:NK
CGGGACTCAATGAACA	L:B:PC
CTATCTACACTCCGGA	L:NK
GGTGAAGAGTGGTTAA	L:T:CD4:Naive
GTGAGTTTCCTACCAC	L:NK
GTTTGGAGTTGTCTAG	L:T:CD8:EMRA
TCATATCGTGGAGAAA	L:T:CD8:EMRA
TCGGGACTCATGTCTT	L:NK
TCGGTCTTCTTCCTAA	L:B:PC
TTCCGTGAGTTGTACC	L:T:CD8:EMRA
ACGGAAGCAAAGACGC	L:NK
ACTTATCTCCTCACCA	L:NK
AGAACCTGTAAGGAGA	L:B:PC
AGGGAGTAGGGCAAGG	L:NK
AGGTGTTTCGTAACTG	L:T:CD4:CM
CATACTTGTAGCTGCC	L:T:CD4:Naive
CATTTCATCGCTCTCA	L:T:CD8:EMRA
GAACTGTCACAAGGTG	L:T:CD8:EMRA
GGAGATGTCTGGCCAG	L:NK
GTGGAGAGTACGAGTG	L:T:CD8:EMRA
GTTTACTTCGCTAATG	L:T:CD4:Naive
TCCATGCCAGTCTGGC	L:NK
TCTCAGCCAAAGTGTA	L:B
TTCATGTCACTGTCGG	L:NK
ACTTTGTAGCGACATG	L:NK
AGCCAGCTCTGGGCAC	L:NK
CAATACGAGGACGGAG	L:T:CD8:EMRA
CGGACACGTCCCTCAT	L:NK
CTAACTTTCGTTAGAC	L:NK
CTAGGTATCGCTCCTA	L:T:CD4:Naive
GAAACCTGTAAGATCA	L:T:CD4:CM
GAGTTTGGTACACGTT	L:NK
TGATGGTCAAGCTACT	L:T:CD8:EM
TGCAGGCAGGTGTGAC	L:NK
TGCAGGCCACAAATCC	L:T:CD8:EMRA
TGGGAAGTCGAACACT	L:T:CD4:Naive
TGTCAGACACTGAGGA	L:NK
TTAGTCTTCGCTAAAC	L:NK
TTTCCTCAGAGCCGAT	L:T:CD8:EMRA
AACCTGAGTTCGGCGT	L:T:CD4:CM
AGATGCTTCTCTTGCG	L:T:CD8:EMRA
ATCAGGTAGATGACAT	L:T:CD4:CM
CAACCTCCAACCTATG	L:NK
CCGGTAGTCGTTGTGA	L:NK
GCAACATCATAGATCC	L:NK
GGAGGATTCACGTAGT	L:NK
GGGACAAGTCGTCAGC	L:T:CD8:EMRA
GGGATGACACGGAAGT	L:T:CD8:EMRA
GTGCGTGGTGCTGTCG	L:NK
TATCTTGTCTAGTCAG	L:NK
TCCCAGTAGAAGGATG	L:NK
TCGTGGGAGCGGTAGT	M:Mono:mDC
TGAGCGCAGAACGTGC	L:NK
TGTAACGGTCTTTCAT	L:T:CD8:EMRA
TGTTCTAAGTCATGAA	L:T:CD8:EMRA
ACTGTCCCAGCATTGT	L:T:CD8:EMRA
AGTCATGGTTCCGCAG	L:NK
AGTTCCCAGCTCCATA	L:T:CD4:Naive
ATCGCCTCAGAGATGC	L:NK
CACTTCGAGTTGGACG	L:NK
TAAGCCAAGTAATTGG	L:NK
TAATCTCCACTGAATC	L:NK
TCACGCTGTAGGTTTC	L:NK
TGCAGATTCATTTACC	L:T:CD8:EM
TGGTACAGTGCATGTT	L:NK
TGTTCTAGTTTCGTAG	L:NK
AAAGTGAAGCGTCAAG	L:T:CD8:EMRA
AATCACGTCAGGGTAG	L:NK
ACTTTGTGTTCGTGCG	L:NK
AGCCACGTCGCTTGCT	L:NK
AGGGTCCTCGCCAGTG	L:T:CD8:Naive
ATTCTACTCAGATTGC	L:NK
CCGGGTATCAACCCGG	L:NK
CCTATCGAGACCAAAT	CD34
CTCAGAAGTTAAACCC	L:T:CD8:CM
CTCTCGAAGTACGTCT	L:T:CD8:EMRA
CTGCATCTCTTAGGAC	L:NK
GAAATGACAAACACCT	L:T:CD8:EMRA
GTCACGGCAGGTATGG	L:NK
GTTCGCTAGTCTAGCT	L:NK
AGCCAGCGTAATCAAG	L:NK
CCTCACACACTGTGAT	L:NK
CGCCAGAGTCAGGTGA	L:T:CD8:EMRA
CGGACACAGCCTCATA	L:T:CD8:EMRA
CTCAGTCAGCTGACCC	L:NK
CTGGCAGGTTGGCCGT	L:NK
CTGTAGACACCCTATC	L:T:CD4:Naive
TCGGTCTGTCGCACAC	L:NK
TTCAGGAAGTAGTGCG	L:NK
CACATGAGTACACGTT	L:NK
CATTTCACAGAGAGGG	L:NK
CCTTCAGGTAACCAGG	L:T:CD8:EMRA
GTAGAAATCTACTCAT	L:NK
GTAGCTATCCCTTTGG	L:NK
TGCTTCGGTCGTCGGT	L:NK
TGGGTTATCAGTGTCA	L:NK
TGGTTAGTCAGAGCAG	L:NK
TTCACCGCATACCACA	L:NK
TTCGCTGGTGTATCCA	L:NK
AACACACCACGCGCAT	L:T:CD4:Naive
AAGTGAATCGGCACTG	L:NK
ACTTATCAGTTACGTC	L:B:PC
AGGAAATGTTGGACTT	L:T:CD8:EMRA
CGAATTGCAGGCTTGC	L:NK
GAACACTTCGAGGCAA	L:T:CD4:CM
GTGCACGCAGGTTTAC	L:NK
TAAGTCGCAAGTGGGT	L:NK
TATACCTCATGGCCCA	L:NK
TCGAAGTAGTCTTGGT	L:NK
GAGTTTGAGGATACCG	L:NK
GCATTAGGTGTGCTTA	L:NK
GCCAGGTCAAAGCTCT	L:T:CD8:EMRA
GCTACAACAGCTATAC	L:NK
GGAATCTGTAGCACAG	L:NK
GGCTTTCAGCAAACAT	L:NK
GTAGGTTGTAGACTGG	L:NK
TAAGCACTCGCCAATA	L:NK
TAGGTTGCACAAGTGG	L:NK
TCAAGTGGTTTCTATC	L:T:CD8:EMRA
TCTTAGTCATCAACCA	L:NK
TGATCAGCAAGGCTTT	L:NK
TGATGCATCTTCGTAT	L:NK
AGTAACCCAGCCGTCA	L:NK
CACAACACATCCGAAT	L:NK
CGTTAGATCACCTGTC	L:NK
TCAGTCCAGACGACGT	L:T:CD8:EMRA
AGAAGTACAATCCTTT	L:T:CD8:EMRA
AGAAGTATCTAGCATG	L:T:CD8:EMRA
AGCCACGCAGACCCGT	L:NK
AGGACGAGTCGATTTG	L:T:CD8:EMRA
AGTGACTCACTATGTG	L:T:CD4:CM
ATAGACCAGATACGAT	L:NK
ATGAGTCCAGAACATA	L:T:CD4:CM
CGCATAAAGAATCGTA	L:NK
CGGCAGTAGTCGCCAC	L:NK
CTCTCGAGTTCGGTTA	L:NK
CTGTGGGAGCAGTACG	L:NK
TGCAGATCAAGTCCAT	L:NK
AAGAACAGTAGTGCGA	L:T:CD8:EMRA
AGGATAAGTCTCTCTG	L:T:CD8:EMRA
CCGGGTACATCATTGG	L:NK
CCTGTTGTCGGCAGTC	L:NK
GAAGCGATCTCACCCA	L:T:CD8:EMRA
GAATCACAGCAGTCTT	L:NK
GTTGTAGAGTTGCGCC	L:NK
TACCCACAGGCCCGTT	L:NK
TCATTACAGTTTAGGA	L:NK
TCGGATATCTACACAG	L:NK
TTCCGGTGTGACACGA	L:NK
TTGACCCGTATCGTGT	L:NK
CCTGCATCAGTGTGGA	L:T:CD4:EM
CTTCTAACAAGGCAAC	L:T:CD8:EMRA
GCCAGCATCTCTCTTC	L:NK
AGGCCACCAATGGCAG	L:T:CD8:EM
CACCAAAGTTCTCTCG	L:NK
CCACGTTTCGACATCA	L:NK
CGCATGGCATATGAAG	L:NK
GGAATCTAGTGATAAC	L:T:CD8:EMRA
TACCCGTAGATGCTGG	L:NK
TACGCTCGTGATATAG	CD34
TAGAGTCGTCATCACA	L:NK
TATTTCGCAAGCCTGC	L:NK
TCCGAAAGTCCAGGTC	L:NK
ATGGAGGTCGAGATAA	L:T:CD4:CM
CCGCAAGAGTGACCTT	L:NK
GCGTGCAAGGTGAGCT	L:NK
GGTCACGTCATGGATC	L:NK
GTAGCTAAGCATGGGT	L:NK
GTGATGTAGCGACTAG	L:NK
TCCGATCTCAATCTCT	L:NK
TGCATGAAGTAAAGCT	L:NK
TGCTCCAAGCATACTC	L:NK
TTGGGATAGGCCCGTT	L:NK
AGCCACGGTGCAGGAT	L:T:CD4:CM
AGCTCAAAGACTGTTC	L:NK
AGTCATGGTGCATTAC	L:NK
CTCCTTTGTAGTCACT	L:NK
GTCTGTCCAGCTGCCA	L:NK
TGCAGATGTTCATCTT	L:NK
CGAAGGAAGTGCTAGG	L:NK
CTACCTGCATCGAACT	L:NK
GAGGCCTGTCTACATG	L:NK
GCCAGTGCAAAGCAAT	L:NK
TAATCTCCACCAGCTG	L:NK
TACAACGAGTCCCGGT	L:NK
TCATACTGTCCTACAA	L:NK
TCATGCCGTAGACACG	L:NK
TTAATCCTCTAGACCA	L:NK
TTCTTGATCCCGTAAA	L:NK
AAGAACACAAGTTCCA	L:NK
AAGCCATTCGCTAAAC	L:T:CD8:EMRA
ACAGGGAGTGGCATCC	L:NK
ACCCAAATCAAGCCTA	L:NK
ACTCCCAAGATAGCAT	L:NK
AGTCATGAGAGTCTGG	L:NK
CCTCCAACAAGACCTT	L:NK
CTCTCGATCTTGGAAC	L:NK
GGGTATTTCCGAAGGA	L:NK
GGGTCTGTCCGTCACT	L:T:CD8:EMRA
TTTCCTCCATGGTACT	L:NK
AAACGAAAGTGATAAC	L:NK
ACAACCACACACCGCA	L:NK
ACTGTGAGTAGACTGG	L:NK
GACCTTCTCAACCTCC	L:NK
GTGTCCTAGGAGAGGC	L:T:CD8:EMRA
GTGTTAGTCATTACCT	L:T:CD8:EMRA
TGACTCCGTTATGTGC	L:NK
TGAGTCAAGCGCACAA	L:NK
TTCAATCTCCGAACGC	L:NK
TTCTAGTAGGTGCTTT	L:NK
ACAAAGATCTTAGCCC	L:NK
AGGAATACACCGGCTA	L:NK
ATCGCCTTCTAACACG	L:NK
CGAAGGATCACGATAC	L:NK
CGCATAAAGTGGAATT	L:NK
CTGTGGGAGGAACATT	L:NK
TATCTGTCATACACCA	L:NK
TGTCAGATCAGGACAG	L:NK
TTGGATGGTACCGTCG	L:NK
AGAGCCCAGCCGAACA	L:NK
AGTACCACAAAGACTA	L:T:CD8:EMRA
CATGCCTGTCCTGTCT	L:NK
CTCCTTTTCATAGACC	L:T:CD8:EMRA
CTCGAGGGTCTCAGGC	L:NK
GAACGTTTCAGCTTGA	L:NK
GACTTCCAGCCTCTTC	L:NK
GGGTATTGTGTCTAAC	L:NK
GTCACTCGTCATGACT	L:T:CD8:EMRA
TTACGTTAGGAAGTAG	L:NK
ATTTACCTCAGCGGAA	L:NK
CGAATTGCACCGCTGA	L:NK
GATCACATCTGAGTCA	L:NK
TATATCCAGTACAACA	L:NK
AACCTGAAGGATTTCC	L:NK
AAGGTAATCCAACTGA	L:NK
GCTACCTAGGCTCCCA	L:NK
GGTTCTCCACGGTGCT	L:NK
TACGGGCTCCTGTAAG	L:NK
TCATTGTCAATAGTCC	L:T:CD8:EMRA
GCATCTCTCCTTATAC	L:NK
GTTAGTGCATCTTTCA	L:NK
TCATGGACAACGTATC	L:NK
AAAGGTAGTCGCGTTG	L:NK
AAGCGTTTCCATCGTC	L:NK
ACGGGTCCATCGATCA	L:NK
CTCAGTCAGTACTGTC	L:NK
GAGACCCGTGGATCGA	L:NK
GATTCGAGTCGAATGG	L:NK
GCGGAAACATGGAATA	L:NK
GGGAGATCATCACCAA	L:NK
TACTTCACACCTGCAG	L:NK
AAGACTCGTTCTAACG	L:NK
GCCGATGGTAGTCTTG	L:NK
GGCTGTGAGACGACTG	L:NK
TCGGATATCTTAGCCC	L:NK
TCTGCCACAGTCTCTC	L:T:CD8:Naive
AAACGCTAGGGACAGG	L:NK
ACTTAGGAGCTCGGCT	L:T:CD8:EMRA
GGTGGCTTCGAACCTA	L:NK
TTGCATTGTGTTACAC	L:NK
AATGAAGGTTGCCAAT	L:T:CD8:EM
AGATGAAAGATAGCAT	L:NK
AGGTAGGCACGTCTCT	L:NK
GAGGGTACACTGTGAT	L:NK
GTCACTCTCAAGATAG	L:NK
TTTATGCCAATCCAGT	L:NK
AGCGTATAGCAGTAAT	L:NK
CAGATTGTCCGGTAAT	L:NK
CGAGGAAGTCTCCCTA	L:NK
GGGTGAACATTGCAAC	L:NK
TTGCATTGTGCATGAG	L:NK
ACGGAAGCATGGGAAC	L:NK
ATCACAGAGAAGCGGG	L:NK
GACCCAGTCGAGTGGA	L:NK
TCACTATAGTAACGAT	L:NK
TTTAGTCGTCCAGTTA	L:NK
ATCCACCTCATTGCCC	L:T:CD8:EMRA
CTCCGATTCAGTGATC	L:NK
CTCTCAGTCTGTCGCT	L:NK
GAGTTGTGTGTTTCTT	L:NK
TTGCATTCATGCACTA	L:T:CD8:EMRA
CGACAGCCACTAGGCC	L:NK
CTTCCTTTCAAGAGTA	L:T:CD8:EMRA
GCCAGGTAGGTCATTC	L:NK
GGGACAATCCCAGGAC	L:NK
TTTCCTCTCTTCCCAG	L:NK
AAAGTGAAGGGCAACT	L:NK
AATGGAACATGCAGGA	L:NK
CGGGTGTTCAATGCAC	L:NK
CTCTGGTTCTATTGTC	L:NK
GAGTGAGTCGGCTATA	L:NK
ACAGAAACACTACACA	L:NK
AGCTACAAGGCATCAG	L:NK
TAGGTTGCACCTCGTT	L:NK
TGGGTTAGTAGGCTGA	CD34
TGTTCATAGTTGTCGT	L:NK
TTTGGAGTCCCGAGGT	L:NK
CATACAGCAAATGCGG	L:NK
GACACGCGTGATGGCA	L:NK
GTTCATTTCCGTTGGG	L:NK
TCACTCGGTCAGATTC	L:NK
TCCGAAACATATACCG	L:NK
TGAATGCTCCTCTAAT	L:NK
TGACAGTAGAAGCGAA	L:NK
TGAGCGCCACTCTAGA	L:NK
TTTATGCCATTGAGCT	L:NK
AGAAATGGTTTACTTC	L:NK
CATGCGGGTAGGCAAC	L:NK
GGTAACTTCACAGTGT	L:T:CD8:EMRA
GTTACCCTCATGGAGG	L:NK
GTTGTAGGTACGCTAT	L:NK
TAGGTTGCAGAATGTA	L:NK
AACTTCTAGCAGCCCT	L:NK
ATTGTTCCACGGTCTG	L:NK
GCATGATGTACCAATC	L:NK
GGAGGATCATAACTCG	L:NK
TCCTCGACACCATATG	L:NK
TGCATGAGTCGCATTA	L:NK
TGCGACGGTTGCGAAG	L:NK
AAAGTCCGTCTGATAC	L:NK
ATAGACCCACGCGCTA	L:NK
GTGGAAGGTCAAACGG	L:NK
TAGCACAAGCGAAACC	L:NK
ACACAGTTCACGAGGA	L:NK
GAAGTAATCATTCGGA	L:B:PC
GAGACTTAGATACAGT	L:NK
ACCAACAGTGCAACGA	L:T:CD4:Naive
TAGACCACATGCCGGT	L:NK
TTACCATAGTCGGCCT	L:NK
ATACCGATCAAACGTC	L:T:CD8:EM
CAAGCTAAGTAAACGT	L:T:CD8:EMRA
CCTCACAGTTAAGGGC	L:NK
GTGACGCCATGTCGTA	L:NK
GTGTGGCCAGCTGCCA	L:NK
TCTTTGAAGGTAGATT	L:NK
AACGTCATCGTTTACT	L:NK
ATCACGAAGCACTCGC	L:NK
ATTACTCGTAGATTGA	L:NK
ATTCCCGAGAAACTAC	L:NK
CAACAACGTGTAAACA	L:NK
CTTTCGGCATCAGCAT	L:T:CD8:EMRA
GAGTGAGAGAAACTCA	L:NK
TTAATCCAGTACGTCT	L:NK
ATCTCTAAGTCCGTCG	L:NK
CTCCACACACAAGCCC	L:NK
GGGCTACGTTTGTGGT	L:T:CD8:EMRA
TCACTATCAGCTGTCG	L:NK
TCCCATGAGCGTACAG	L:NK
TCGAACACAGAAGTTA	L:NK
TGAGACTCAGCGCGTT	L:NK
AGCTACACACCCTATC	L:NK
ATCAGGTGTCATCCGG	L:T:CD8:EMRA
ATCGATGCACATACGT	L:NK
ATTCACTGTACCAATC	L:NK
TCACAAGAGTAACCTC	L:NK
ATAGGCTAGCACAAAT	L:NK
ATCGATGTCGAAATCC	L:NK
ATGATCGCATGTGCCG	L:NK
CGCATAATCTCTCTTC	L:NK
TGATCTTGTAGGAAAG	L:NK
TGATGGTGTGCGCTCA	L:NK
TTAATCCCATGACGTT	L:T:CD4:CM
GGTTCTCAGTACCATC	L:NK
TACACCCAGTTCACTG	L:NK
TACAGGTCACCTATCC	L:NK
TACCCACCATGGGTTT	L:NK
TATCGCCAGCCTCACG	L:NK
CATCCGTGTAAGGTCG	L:NK
CTAGGTATCACGAGGA	L:NK
GGCTTGGGTAAGATAC	L:NK
GGTCACGCAGCAGGAT	L:NK
GTGCACGAGCTGCCAC	L:NK
AAAGGTAAGGTTACAA	L:T:CD8:EMRA
CTGGCAGAGGTTGGTG	L:T:CD8:EMRA
TCTAACTTCATTTACC	L:NK
TGATTTCAGACCTCCG	L:T:CD8:EMRA
ACACCAATCTTAGCCC	L:NK
ATCAGGTAGACTGAGC	L:NK
CCCTAACCAGATCCAT	L:NK
CCGTTCACAATCAGCT	L:NK
CGGCAGTAGTTGAATG	L:NK
GCCCAGAGTGTTACTG	L:NK
TTGGGCGGTCCCTGAG	L:NK
CTGGTCTAGGGCATGT	L:NK
GAGTGTTTCTGCTGAA	L:NK
TGTTACTTCCCTTCCC	L:NK
CTACTATCAGTAGAAT	L:T:CD8:EMRA
TCAAGTGGTTCCACAA	L:NK
TGGTACAGTAGCGAGT	L:NK
AAGGAATGTTAGGGTG	L:NK
AGATCCATCAGTCCGG	L:NK
CATTGCCCATGTGCTA	L:NK
CTATAGGTCGCGGTAC	L:NK
TCAATCTTCAGGAACG	L:NK
TCATTCAGTTCTTCAT	L:T:CD8:EMRA
ATGGTTGAGAAACCAT	L:NK
CAGCGTGTCCGCTTAC	L:NK
GATCGTAGTGACTCTA	L:NK
TACTTACGTCTCTCCA	L:NK
TCATCCGAGGACACTG	L:NK
TGGGCTGCATTCACAG	L:NK
AGAAGCGAGTAAACTG	L:NK
CCGGTGATCGGACTGC	L:NK
CTTCTAAAGCGAACTG	L:NK
GTAACCAGTACCCGCA	L:NK
TACGCTCAGCGCCTAC	L:NK
TCAAGACCAATACGCT	L:NK
TTCCGGTGTCAATGGG	L:NK
CTAGACACAGGCCCTA	L:NK
GCCAACGAGGACATCG	L:NK
TACTGCCTCGATTGGT	L:NK
AGTAGCTCACGGTGTC	L:NK
CGGACACAGTTCCGTA	L:NK
CTATAGGGTCCTGAAT	L:NK
GTTACAGCACTCCCTA	L:NK
TGAGGAGAGTTGGCGA	L:NK
AACCACATCCCGAGGT	L:NK
AGGGAGTTCTAACGGT	L:NK
GAGTTTGTCGTCACCT	L:NK
GTGTCCTGTCTTTCTA	L:NK
TGATCAGCACTCCGAG	L:T:CD8:EM
ACTTCCGGTAACCAGG	L:NK
ATGTCCCTCGTGCATA	L:NK
ATTCTACCATTCAGCA	L:NK
GATAGAATCGCGCTGA	L:T:CD8:EMRA
GGGTCACTCGCACGAC	L:NK
TACTTGTCATTGGCAT	L:NK
AACAAAGGTCGCAGTC	L:NK
AACAAGACAAATAAGC	L:T:CD8:EMRA
CTTGAGAGTACGATTC	L:T:CD8:EMRA
GTAATGCGTGGAAATT	L:NK
GTACAGTCACGTAACT	L:NK
TTCTTCCTCATAGAGA	L:NK
TTTACCAGTCTACAGT	L:NK
ACTATGGAGTTTGAGA	L:NK
ATTCACTAGGATACAT	L:NK
ATTTCTGAGGTAAAGG	L:NK
GAGCCTGGTATGTCAC	L:NK
GAAGCGAGTGTTCCAA	L:T:CD8:EMRA
TACTGCCTCTGCGGGT	L:NK
TCGGATACATGGAATA	L:NK
AAACGAACAACCGACC	L:NK
ATCCATTAGCTAGAAT	L:NK
ATTACCTGTATGGAAT	L:NK
TCGATTTCAATAGTAG	L:NK
TCGGATAAGATCCGAG	L:NK
TGTCAGACAAGTTCCA	L:NK
GAACTGTGTGGGTTGA	L:NK
TGCGACGTCACTGTTT	L:NK
GTTGTGATCAATCCAG	L:NK
TAGAGTCGTTTCGTAG	L:T:CD4:CM
TCATCATCACCTGAAT	L:NK
AGATGCTAGGTACAAT	L:NK
GCGGAAAAGGCGATAC	L:NK
TTCTTGATCAGTCACA	L:NK
CACTAAGTCAACGAGG	L:NK
GAGAGGTAGCCTCTGG	L:NK
GCACATATCAAATAGG	L:NK
TAAGCGTAGGACTATA	L:T:CD8:EM
TTTACCAGTATGTCCA	L:NK
AGCGCTGCAATGTGGG	L:NK
GGTAACTCAGCAGGAT	L:T:CD4:CM
TATTGGGCAGCACAAG	L:NK
AGCCACGTCTATCACT	L:NK
TACGTCCAGTACCCTA	L:NK
GAATCACTCTGCTAGA	L:NK
CAGGCCATCCTGTACC	L:NK
TAGAGTCGTATAATGG	L:NK
AGGTCTATCGTAACCA	L:NK
ATCTTCATCTCCCATG	L:NK
GCAGCTGCAACAAGAT	L:NK
TCTCCGATCGGAAACG	L:NK
CGAGGAAGTAGCACAG	L:NK
CTCCCTCAGGTCCCGT	L:NK
CTGTACCCATGAGTAA	L:NK
GATGATCCATTCTTCA	L:NK
AGGTTGTTCGACATCA	L:NK
CGCCAGAAGGAAAGAC	L:NK
GCACATATCTCCTGTG	L:NK
TTACCGCCACTCCTGT	L:NK
AAGTACCCAAGAGGCT	L:NK
TGTTCTAGTTCCACAA	L:NK
AAAGGGCCAATAAGGT	L:NK
AGGGCTCCAATTGCGT	L:NK
CAGAGCCCAGACTCTA	L:NK
GACGCTGAGCCTATTG	L:NK
TAACCAGAGGCGAAGG	L:NK
TTCCGTGTCCATTTGT	L:NK
CATACAGGTCATCCGG	L:NK
CCCAACTAGCATCAAA	L:NK
CCCAACTCACTTGGCG	L:NK
ACCCAAAGTCCTTAAG	L:NK
AGACAGGTCTAACGGT	L:NK
GATGATCTCGCCAACG	L:NK
AGACAGGCAATGTCTG	L:NK
GTCACTCCATCCTTCG	L:NK
GTGGCGTTCCTTTAGT	L:NK
TCATGCCGTGCCTTCT	L:NK
TGTGTGAGTTGGACCC	L:NK
CTACATTAGTCGCTAT	L:NK
CGGAGAAGTAGCCCTG	L:NK
TCAGGTATCGCATTAG	L:NK
CTGTGGGCAATCTCTT	L:NK
TATTGCTAGTTCTCTT	L:NK
TGCTTGCTCGCTCCTA	L:NK
TTACGCCTCTTCGGAA	L:NK
TTCTCTCGTTTACGAC	L:NK
AATTTCCCACAATGAA	L:NK
CCTGTTGAGCTACTAC	L:B:PC
CAAAGAACAGCCGTCA	L:NK
GGAGAACCAAGGTACG	L:T:CD8:EMRA
CAACGGCGTTGGCCGT	L:NK
TAACCAGCATTACGGT	L:NK
CGAGAAGTCTTTACAC	L:NK
ATGAAAGGTGTCTTGA	L:NK
TTACGCCCATTCTCTA	L:NK
TCCGAAAAGAGAATCT	L:NK
GCCATGGAGAGGACTC	L:NK
TAACACGAGATAGGGA	L:NK
TTAATCCGTCGACGCT	L:NK
ACCTGAAAGGGCAGTT	L:NK
CAGGGCTGTCCTCCAT	L:NK
CATGGATAGTCGGCAA	L:NK
ATGAAAGGTCCAGCCA	L:NK
AGGTCTACAGGACAGT	L:NK
AGATGCTCAACGATTC	L:NK
ATCGTAGTCAACGTGT	L:NK
TGCGATAGTCCTCAGG	L:NK
TCCACGTCATGTTCGA	L:NK
CATACTTTCAACTTTC	L:NK
ACAAAGAAGTACTCGT	L:NK
CCTATCGAGAATCCCT	L:NK
TGTTGGATCCAACCAA	L:NK
GGGCTACCAAAGGCGT	L:T:CD8:EMRA
AAAGAACTCCTCAGGG	L:NK
TCTCACGCAGGTGAGT	L:NK
GAGTGAGCAAGCGATG	L:NK
TGTCCCATCCTCACGT	L:NK
TCATTGTAGGTAGTAT	L:NK
TTTGTTGTCCAACCAA	L:NK
AAGGTAACAGGCAATG	L:NK
AGTTAGCAGAGAGAAC	L:NK
GTTTACTCATACCAGT	L:NK
AAGGTAAGTGTCTTAG	L:NK
TGTGATGCACAGCTTA	L:NK
GGACGTCTCAGCAGAG	L:NK
GGTTCTCCAATGCAGG	L:NK
CCGGTGAGTGAATATG	L:NK
GGTTGTACAACCGATT	L:NK
TCAGTTTCATGACGTT	L:NK
ACCTACCCAGTCTGGC	L:NK
CCGTAGGTCAAAGAAC	L:NK
TTTACGTCAACCAGAG	L:NK
AGAGAATGTCTCCCTA	L:NK
TAAGTCGCAGGTAGTG	L:NK
GATGATCTCTTCCCAG	L:NK
GGGTATTGTAGTCTGT	L:NK
TGCCGAGGTTACGGAG	L:NK
TGAATGCTCACTACTT	L:NK
GTCTGTCAGTCAGCGA	L:B:PC
TGTTGGAGTTGCATTG	L:NK
GGAGCAACAATGTGGG	L:NK
TACCGGGGTGCAGATG	L:NK
AACCTGAGTATCACGT	M:Mega
TCCCATGGTGAACGGT	L:NK
GCTTTCGAGACTCGAG	L:NK
GCCAACGTCTGGACCG	L:NK
AGGTCATGTAGAGTTA	M:Neu
CATCGTCGTGTCGATT	M:Neu
TCGTGGGTCTGGTGCG	M:Neu
CGTGTCTCAGGCATTT	M:Neu
GGGATCCAGAGGTTTA	L:B:PC
ATCGTGAAGCAATTCC	M:Neu
GCATCGGGTAGCACGA	M:Neu
ACGCACGGTTACGATC	L:NK
TGTTGGAGTGCGTCGT	M:Neu
CCGGGTAGTGATATAG	M:Mono:mDC
GTCGCGACACAGCATT	M:Neu
CGTGCTTAGCGACTGA	M:Neu
AGTTAGCGTCTGTGAT	M:Mono:mDC
GTCGTAAGTGAGTAGC	M:Mono:mDC
TCGTCCAAGGATATGT	M:Neu
GGTGTTACACAAACGG	M:Neu
CGTCAAACATGGGATG	M:Neu
ATCGGCGTCGCATGAT	M:pDC
AATGGAACATACACCA	M:Neu
GCGTTTCGTGTTAACC	M:Neu
TCGCTCATCCTGGGAC	M:Neu
TCGGGCACAAGGAGTC	M:Neu
TGGGAAGAGGTTGGTG	M:Mono:mDC
GTCGCGATCCCAAGCG	M:Neu
AGTTAGCTCAGCGTCG	M:Neu
CCCTCAATCCATCTAT	L:T:CD4:CM
GCGGAAATCGCGCCAA	M:Neu
GGGTTATCACATAGCT	M:Neu
GTGGCGTAGCTCTTCC	M:Neu
TCGGATAAGCAATTAG	M:Neu
TGTAGACCATGCCGAC	M:Neu
CTACGGGAGTCCTACA	M:Neu
CGATGCGTCTACACTT	M:Neu
ATCACAGAGCCATTCA	M:Neu
CGAGTGCGTCATATGC	M:Neu
CGTGCTTAGGATTCCT	M:Neu
GTCAAACCACCACATA	M:Neu
TCTTAGTGTTGAGGAC	M:Neu
CAACGGCGTGCAGTGA	M:Neu
TGAGGGAGTGGCTAGA	M:Mono:mDC
AATGACCCAGCTGTTA	M:Neu
TCTCACGCAAACTCTG	M:Neu
CGTGATAAGAGGCTGT	M:Neu
TCATTCACAAATGCTC	M:Neu
AAGTCGTCACACTGGC	M:Mono:mDC
TACACCCTCATGCAGT	M:Neu
TGTAGACTCGTGACTA	M:Neu
CATGCGGTCTACGGTA	M:Neu
TCATGAGGTAGGGTAC	M:Neu
CGATCGGGTCAGGAGT	M:Mono:mDC
CGTGTCTGTCGTACAT	M:Mast
GGGCTCAGTTAAGGGC	M:Neu
GCCAGGTAGTGCACCC	M:Neu
CGATGGCCAGACGATG	M:Neu
TCGGGACAGTAACCGG	M:Neu
AAGGAATAGCATCGAG	M:Neu
GTCGAATTCAGTGTGT	M:Neu
CAAGACTAGTAGGTTA	M:Neu
GGGTCTGTCAAAGACA	M:Neu
GTCGCGATCCAGCCTT	M:Neu
AACCATGAGGTCTGGA	M:Mono:mDC
TCGACGGCAGGTTACT	M:Neu
ATTTCACGTCGCGTTG	M:Neu
AAGCGTTGTGCCTACG	M:Neu
ACCCTTGTCCCGAGGT	M:Neu
CCTCAGTGTCAACATC	M:Neu
TTTACGTGTTGGGCCT	M:Neu
GTTACGATCGGCCAAC	M:Neu
TTTCACACACCGCTGA	M:Neu
GTCTAGATCGTTCAGA	M:Neu
CTTCCGAAGTCTGGAG	M:Neu
TCCACCAAGGGAGGGT	M:Neu
GTTACAGCATAGAATG	L:B
CTCTCGAAGCCTCGTG	M:Mono:mDC
TTTCGATGTTGGACTT	M:Neu
ATCGATGCAGATCACT	M:Neu
ATTATCCGTCCTACGG	M:Neu
GACCGTGCAAAGGAGA	M:pDC
CGAGAAGAGCCGATCC	M:Neu
TCCTCCCGTCGTTGCG	M:Neu
CTGGTCTAGCGTCTGC	M:Neu
GTTGTGAAGTGAGTGC	M:Neu
ATCGGCGCAATTAGGA	M:Neu
TTAATCCGTGTTTCTT	M:Neu
TTTGACTTCCATTTCA	M:Neu
TCGTAGAGTCGGATTT	M:Neu
TGAACGTAGACTTGTC	M:Neu
CATTGCCCAATGAGCG	M:Neu
GCGATCGAGCAAGGAA	M:Neu
TGGGCTGGTTACGATC	M:Neu
TTCCGGTAGCCTTTCC	M:Neu
CTTCCTTGTTCTTGCC	M:Neu
CATTCTATCCACGTAA	M:Neu
TCCGTGTCAATGAAAC	M:Neu
CGTTGGGAGTAGGTTA	M:Neu
GGGATCCGTGAGTGAC	M:Neu
TCAGGTACATGGGATG	M:Neu
GGGACCTTCATTTCGT	M:Mono:mDC
AACCAACAGTGGTGGT	M:Neu
TTTCCTCGTGCTGATT	M:Neu
ATCACGACAAGAAACT	M:Neu
TCCCATGAGGATTTCC	M:Neu
AATTCCTTCTCCACTG	M:Neu
AGATGCTAGATGGGCT	M:Neu
TCTTCCTTCGAGAACG	M:Neu
TGCACGGAGCACTCTA	M:Neu
TTAGTCTCATACCATG	M:Neu
CGGGCATAGGAAGAAC	M:Neu
GGTGGCTAGTACGAGC	M:Neu
TCCGTGTTCTGAACGT	M:Neu
TCCTCCCGTGCCCGTA	M:Neu
CCTCTCCCATGAGATA	M:Mono:mDC
TTCCTAAAGACCTCAT	M:Neu
CATGGATCAAGGTTGG	M:Neu
CCTCCAAAGAGTAACT	M:Neu
AGGATAAAGGAAGTAG	M:Neu
GCGATCGTCGAACCTA	M:Neu
GGACGTCGTAATGATG	M:Neu
CAACGATTCATTTCGT	M:Neu
CCCTTAGGTGGGATTG	M:Neu
CCGTGAGGTAACATAG	M:Neu
CTTCCGAGTCCCTCAT	M:Neu
TACTTCACATGACGAG	M:Mono:mDC
TGAGTCATCTTGGATG	M:Neu
TTTACTGCAGTCGCAC	M:Neu
ATGACCAGTCTAGTGT	M:Neu
GGTAACTTCGTTCTGC	M:Neu
TGTGAGTGTAGCTGTT	M:Neu
GCAACATTCCGCGGAT	M:Neu
AAAGTGACAGCGGTCT	M:Neu
AGTAACCGTTGAGAGC	M:Neu
GCCAACGTCGAAGTGG	M:Neu
TCGTCCATCACTACTT	M:Neu
ATGGTTGAGGTTATAG	M:Neu
GTCATTTTCTCGCGTT	M:Neu
GTGACGCTCGTTCTGC	M:Neu
TCGCACTCATAACGGG	M:Neu
TTCCGTGTCACATACG	M:Neu
CATTGTTCACTGGCGT	M:Neu
TACTTGTAGGAGTACC	M:Neu
TCTATACAGCCATATC	M:Neu
AGACAAATCCAGCCTT	M:Neu
ATACTTCCACTTCTCG	M:Mono:mDC
GAACACTAGAATTGCA	M:Neu
GGTAGAGTCCACTGGG	M:Neu
TCAATCTCAGAGCCCT	M:Neu
ACCCAAAGTCAGATTC	M:Neu
CGTTAGATCCCATGGG	M:Neu
TCCTCGAAGTGCGCTC	M:Neu
CATCCGTAGTAACCGG	M:Neu
GGGAGATTCGCTCCTA	M:Neu
GTCCCATAGTTAGAAC	M:Neu
ACGGTCGCACAAGGTG	M:Neu
AGAGAATCAATGGCAG	M:Neu
CGAAGGAAGAGCAGCT	M:Neu
AGACCATGTCCCAAAT	M:Neu
ATGAGTCCATGAATAG	M:Neu
TGCAGGCAGGGTGGGA	M:Neu
GTCCCATCAAGAAATC	M:Neu
GTCTCACAGAGCCCAA	M:Neu
ATACCTTCACCCTTAC	M:Neu
CGTTAGACATGCCGCA	M:Neu
GATCAGTCAGCATGCC	M:Neu
GTGAGGATCGTGTGAT	M:Neu
AGTGATCGTGTTCCAA	M:Neu
ATGTCTTAGGTCGCCT	M:Mast
CAAGCTAAGCCGTTAT	M:Neu
CGTTGGGTCGGAGATG	M:Neu
CTGAATGGTCGCTCGA	M:Neu
TCATATCTCATGGATC	M:Neu
GAAGCGACAAGTGACG	M:Neu
CGTCCATAGACTCTTG	M:Neu
AGCCAATAGGCAGCTA	M:Neu
CTCAAGAAGGTCCGAA	M:Neu
GACGTTAAGCTCTTCC	M:Neu
TAGATCGAGACCACGA	M:Neu
TCGGGTGAGCCTCAAT	M:Mono:mDC
CGAGTTAAGGTGCAGT	M:Neu
TCCTGCAAGCACTCAT	M:Neu
ACATCGATCGCTGACG	M:Neu
CCGGTAGTCACCTGTC	M:Neu
GAACACTAGGCTAAAT	M:Neu
TCGGATAAGGACTATA	M:Neu
TGATGGTGTACCCACG	M:Neu
TGCGATACACAACGTT	M:Neu
ACGTAGTGTGGACAGT	M:pDC
AGCGCTGCAATCGTCA	M:Neu
GCGATCGGTACTCGAT	M:Mono:mDC
GTCCCATAGCCTGTCG	M:Neu
TACCGAACAGACAAGC	M:Neu
TGTGCGGCACACAGAG	M:Neu
CCGTGAGGTCGATTAC	M:Neu
CCTTCAGCAACCAGAG	M:Neu
GCACGTGTCCACATAG	M:Neu
TCCTCTTCAGCACACC	M:Mono:mDC
TGCAGGCTCTCCGTGT	M:Neu
TTTACGTCATTAGGAA	M:Neu
AATGCCAAGATACTGA	M:Neu
ATTCCCGAGTAAACAC	M:Neu
CAGTGCGGTGGTAACG	M:Neu
GACCTTCGTACCTTCC	M:Neu
GGAAGTGCACAAAGCG	M:Neu
CCTCCTCGTCACAGAG	M:Neu
CGTCAAACAGTTAGAA	M:Neu
CTCCAACAGGTCTTTG	M:Neu
GATCCCTTCCGGTAAT	M:Neu
CATCCGTAGGCACCAA	M:Neu
CTGCCATAGACCCGCT	M:Neu
GAGGCCTCAAACCACT	M:Neu
GTAGAGGTCCCATACC	M:Neu
TACCCGTCAACTTGCA	M:Neu
TACTGCCAGATAGCAT	M:Neu
TTCCAATTCATTGCGA	M:Neu
TTGCTGCCACTATCCC	M:Neu
CGTAATGTCCACAGGC	M:Neu
TAACACGTCGGCTGTG	M:Neu
GTTGTGAGTGACCGTC	M:Neu
TCTTCCTGTGGCTGCT	M:Neu
AGCGTATCAACCGCTG	M:Neu
TCCCAGTCAGCCGTTG	M:Neu
TTCTTCCAGGGCAAGG	M:Neu
AAACGCTCAAATCGTC	M:Neu
TATCGCCAGCGAATGC	M:Neu
ATCAGGTGTTACCCAA	M:Neu
CGTAATGAGGATGGCT	M:Neu
GCACGGTGTACCGCGT	M:Mono:mDC
TGACGCGTCTGAGCAT	M:Neu
TGGGAGACACGTGAGA	M:Neu
TTGTTTGAGGTACATA	M:pDC
CGAGTTATCAGCGCAC	M:Neu
CTGTGGGAGGACAGTC	M:Mono:mDC
CTTCGGTAGTCAACAA	M:Neu
GGGATGAGTTCATCGA	M:Neu
TCGCACTAGAGGGTGG	M:pDC
TGTGCGGGTGTCCAAT	M:Neu
ATCGCCTTCTATACTC	M:Neu
TAGTGCACACCGCTAG	M:Neu
GACCCTTTCTTCCGTG	M:Neu
TCACGCTGTTACACTG	M:Neu
TCACTATTCGAAGTGG	M:Neu
TTTCAGTGTTCTCCTG	M:Neu
AAGAACACAAAGGCTG	M:Neu
CTATAGGGTTGCCTAA	M:Neu
TGCAGATGTGTCCATA	M:Neu
GATCCCTGTTGCCATA	M:Neu
GTCGCGATCTGCTTAT	M:Neu
TCATCATCAAATAGCA	M:Neu
ATTTACCTCAAGGCTT	M:Neu
CATGCCTCAACAGTGG	M:Neu
CTGCGAGTCCGTATGA	M:Neu
ACTTTGTAGGCAGGGA	M:Neu
GTATTTCGTATACGGG	M:Neu
CCAATGACAGAAGTGC	M:Neu
TACACCCCAATTGAAG	M:Neu
TCCACGTCATCTCGTC	M:Neu
TTTGATCAGTGAATAC	M:Neu
ATGCCTCGTGCATCTA	M:Neu
CCAAGCGTCTTCCAGC	M:Neu
TCACATTAGTGGAAGA	M:Neu
TGCTTCGAGGAATTAC	M:Neu
ATGCATGCACTACACA	M:Neu
CATTGCCCAAAGCTAA	M:pDC
CCCGGAAAGAAATTGC	M:Neu
TCTACATTCGTCAAAC	M:Neu
ATTACCTCATGAGAAT	M:Neu
CCATCACGTTATGACC	M:Neu
CCGGTGATCGATACAC	M:Neu
CTCCTTTTCGTACACA	M:Neu
GATTGGTGTAGAGTTA	M:Neu
TATCTGTAGTTAACGA	L:NK
TGGTTAGAGCATGCAG	M:Neu
AGGACTTGTAATTGGA	M:Neu
CAGTTAGCAACGATTC	M:Neu
CGATGCGAGTAGTCCT	M:Neu
GACTTCCGTACCGTCG	M:Mono:mDC
GATAGAAAGGTCCGAA	M:Neu
GATTCGAAGACGCCAA	M:Mono:mDC
TCATGGAGTGCCCTTT	M:Neu
CTCCTCCTCAGTGTTG	M:Neu
GTGCGTGCACACTGGC	M:Neu
TTCACCGAGTTCTACG	M:Neu
CCCGAAGGTGGTGATG	M:Neu
CCGATCTGTTGGGCCT	M:Neu
CTGAGGCGTTGAGGAC	M:Neu
TGACCCTGTCAGTTTG	M:Neu
AAGGAATGTTAGGACG	M:pDC
ATGAGTCAGGCTAAAT	M:Neu
CCTATCGCAAAGAACT	M:Neu
TACCTGCAGTCAAGCG	M:Neu
AATCGTGAGTACTGTC	M:Neu
ACGATGTGTCAAGCGA	M:Neu
GTCTTTAAGCCTTGAT	M:Neu
GGGCTACAGGCACAAC	M:Neu
GTGACGCTCGAGCACC	M:Neu
TCCAGAACACACCGAC	M:Neu
CTACGGGTCAAGCTTG	M:Neu
CTTCTAATCTTAGCAG	M:Neu
CATTCTATCTACGGGC	M:Neu
CGCAGGTTCTTTCAGT	M:Neu
TATTTCGGTAACACCT	M:Neu
TCATGGAGTAAGTTAG	M:Neu
TTTACTGAGCTGGAGT	M:Mast
AGGAATAGTACGTAGG	M:Neu
CTAACTTTCCATACTT	M:Neu
GTGTAACCACGGGCTT	M:Neu
AGATGCTTCACCGGGT	M:Neu
ATGAGGGGTTCAAGGG	M:Neu
CGGGTGTGTTATTCTC	M:Neu
GCTTTCGGTACCGTCG	M:Neu
GGATCTATCCAGCACG	M:Neu
ACATTTCTCAGATTGC	M:Neu
ACGCACGTCCATACTT	M:Neu
AGGATAACAGGCCTGT	M:Mono:mDC
AGTAGCTTCGAGTTGT	M:Neu
CTTCCGACATGTCAGT	M:Neu
TCATTCAAGGACAGCT	M:Neu
GAAGGGTGTCTGCATA	M:Neu
ACTGATGTCGGCTATA	M:Neu
CAGCCAGCATAAGATG	M:Neu
CGGAATTTCCCTGTTG	M:Neu
GGGTGTCTCTGCTCTG	M:Neu
TTGGGCGTCTCGCTCA	M:Neu
AGTCACACACCAGTAT	M:Neu
CAACCAAAGTGTTGAA	M:Neu
GGTAGAGAGGCTTTCA	M:Neu
GTCATCCTCTGTCGCT	M:Neu
TGTTTGTCATGAAGGC	M:Neu
AGTCATGCACGCGCTA	M:Neu
CAGCAATTCTTAGCCC	M:Neu
CATGCAAGTGGTCTCG	M:Neu
TCAGGTACACCAGTTA	M:Mast
TTCTCTCTCCCTCATG	M:Neu
ACTATGGGTCTCAGGC	M:Neu
ATCACGAGTTCCCAAA	M:Neu
CGCGTGATCATCGCTC	M:Neu
GGAGGATCAAGTAGTA	M:Neu
AACACACCATCATTTC	M:Neu
AATCACGAGTCATGCT	M:Neu
ACTTCCGAGAATACAC	M:Neu
CATAGACTCTCAACGA	M:Neu
CTAGGTAGTTAGAAAC	M:Neu
CTACCCAGTACTGACT	M:Neu
TCGGTCTAGGGCAATC	M:Neu
AATCGACAGCTACGTT	M:Neu
ACAGGGACACTGGCCA	M:Neu
CAACCTCTCACCTTAT	M:Neu
AGTAGTCGTTGAAGTA	M:Neu
GTGATGTGTGGCTGCT	M:Neu
TCATATCCACCATATG	M:Neu
AGGTAGGAGCTAGTTC	M:Neu
AGGTTACTCATTTGGG	M:Neu
ATTCCATAGCACTCAT	M:Neu
CAAGCTACAACAGTGG	M:Neu
GAGGCCTGTCTGCAAT	M:Mono:mDC
ACTGTGACAAATTAGG	M:Neu
CGATCGGAGGAATTAC	M:Mono:mDC
GAGGGTAAGGTCCAGA	M:Neu
GGGAAGTCAGGCAATG	M:Neu
ACGGAAGGTGATTGGG	M:Neu
CACATGAGTTTGGAAA	M:pDC
CGGGACTGTAAGCGGT	M:Neu
AGACCATGTAGCACAG	M:Neu
CTTCCGAAGCAAACAT	M:Neu
GAGACCCGTGGCAGAT	M:Mono:mDC
GCAGCCAAGAACTCCT	M:Neu
CACAGGCCAGGCGATA	M:Neu
GGCTTGGAGTGGTTCT	M:Neu
TCCTTTCTCTTCCGTG	M:Neu
ACACTGATCTCGAACA	M:Neu
ACAGGGACATGGCGCT	M:Neu
AGATCGTCACTTTATC	M:Neu
CACACAAAGTGAGTGC	M:Neu
CCGATCTTCGGTAACT	M:Neu
GACGTTAAGGACAGTC	M:Neu
GAGCCTGAGCATCAAA	M:Neu
GCTACAAAGTAGTGCG	M:Neu
GTCCACTCACTCAAGT	M:Neu
TATCGCCCAAACTAAG	M:Neu
ACGCACGAGACACACG	M:Neu
AGATGCTGTTAGAAAC	M:Neu
CTGCTCACATTGAGGG	L:B
GGATGTTCAAAGAACT	M:Mono:mDC
GTGGAAGTCGACCTAA	M:Neu
ACTATCTCAGCTGAGA	M:Mono:mDC
AGAACCTCAGTTCCAA	M:Neu
ATAGGCTGTACCCGAC	M:Neu
CAATTTCGTAGTGATA	M:Neu
CTCCTCCCAGTAGTGG	M:Neu
TTGTGGAGTTGGAGGT	M:Neu
GGGACCTAGGCGAACT	M:Mono:mDC
GTATTTCTCAGGGTAG	M:Neu
GTTGCGGTCAGCCTCT	M:Neu
TAAGCACTCGGCATCG	M:Neu
TCTAACTAGTTACTCG	M:Neu
ATGACCAAGACCATTC	M:Neu
CAACAGTCAGGTCAGA	M:Mast
AGACCCGGTAGCTTTG	M:Neu
CATTCTAAGTTCAACC	M:Neu
GACTGATTCCCGTGAG	M:Neu
GATTGGTAGGCACTCC	M:Neu
ATGGATCAGCCATGCC	M:Neu
GCATCTCGTATCCCAA	M:Neu
TTCCTTCAGTCAAGCG	M:Neu
AAAGGTAGTGGCGTAA	M:Neu
CACAGATAGCGCCATC	M:Neu
CCCTCTCTCGGTCGAC	M:Neu
CGTGCTTGTGATACCT	M:Neu
TACCTGCCAGAATCGG	M:Mono:mDC
TCGTCCAGTACTCCCT	M:Neu
CCTCAGTTCCTCAGAA	M:Neu
GGGAGTATCCTCACTG	M:Neu
GTTACGAGTGAACCGA	M:Neu
TCACTATAGGAGAGTA	M:Neu
AGCATCAGTTCTGAGT	M:Neu
CTGTACCAGATACGAT	M:Neu
GCTTCACCAATTGTGC	M:Neu
GTTGCTCAGGTCCTGC	M:Neu
TGGTTAGCATCTCGTC	M:Neu
AATCGTGCACAAACGG	M:Neu
TAACGACGTGAGTCAG	M:Neu
CACAGGCCAAAGGGCT	M:Neu
CAGCGTGAGTCCCGAC	M:Neu
GACAGCCGTACGTTCA	M:Neu
GGAGGATCAGAAGTGC	M:Mono:mDC
GTCGAATTCAGCTGAT	M:pDC
TCGTAGATCAGCTTGA	M:Neu
GTCTTTATCAGAGTTC	M:Neu
AATTCCTGTACAAAGT	M:Neu
ACCGTTCGTAGGCAAC	M:Neu
GATGGAGGTTGAAGTA	M:Neu
GGGAGATGTGTGAGCA	M:Neu
TCATCCGCAATTAGGA	M:pDC
TGAGGAGGTGCCTACG	M:Neu
TTGTGTTTCAAGCTTG	M:Neu
TTGCATTGTATCACCA	M:Neu
ATGAGGGGTCAACCAT	M:Neu
GTAATCGTCGGCTTCT	M:Neu
TTCACCGCAGCGTGAA	M:Neu
TTTCCTCAGTTGGCTT	M:Neu
TCCCATGGTTGCTCAA	M:Neu
TGTCAGACATGACGGA	M:Neu
AGAAGCGCATTGACCA	M:Neu
AGCGTATCAAGACTGG	M:Neu
AGTCAACAGCGTATGG	M:Neu
CAGATCAGTATTGCCA	M:Neu
CCCAACTCATACGCAT	M:Neu
CCTCTCCGTGAGACCA	M:Neu
CTTCCTTAGGTGAGCT	M:Neu
TCATTACGTAGCGCCT	M:Mast
TCTTAGTGTTTGCCGG	M:Neu
TGTGCGGAGCGTATAA	M:Mono:mDC
TGTTTGTAGAACTTCC	M:Mono:mDC
AGAGCAGCAGTGGCTC	M:Neu
ATCCTATTCAGTGTGT	M:Neu
ATTTCTGTCATGCGGC	M:Mono:mDC
CCTCACAGTTGGGATG	M:Neu
CTCTCGAGTGATATAG	M:Neu
GAATCGTCAATAGTAG	M:Neu
GGGACCTCAGCTTTGA	M:Neu
TGGTAGTGTCAGGAGT	M:Neu
TTCCTCTAGTTACGTC	M:pDC
ATTCATCGTGACTAAA	M:Neu
CCGTAGGTCTACACTT	M:Neu
CTACCCATCGCAGTCG	M:Neu
CTTAGGACAACGTATC	M:Neu
GGTAATCTCGTTCTGC	M:Neu
GTGATGTGTTTCCCAC	M:Neu
TATACCTAGGATACGC	M:Neu
AAGGTAAAGTGTTCCA	M:Neu
TGGGATTAGTAAGCAT	M:Neu
TTAATCCCAGCGACCT	M:Neu
CTGAATGCACAATGAA	M:Neu
ATGTCCCAGCACACAG	M:Neu
CAGATTGGTCGTGGAA	M:Neu
GCCATTCGTACTGTTG	M:Neu
TCCTCTTAGTCAGAGC	M:Neu
ACACAGTTCTGGCCGA	M:Neu
GAAACCTAGTCTCGTA	M:Neu
GAACACTCATCTTCGC	M:Mono:mDC
CAAGACTTCGCGGTAC	M:Neu
GACTCAAGTAGAGACC	M:Neu
GTCGAATGTCGGTAAG	M:Neu
AACACACGTTGTCAGT	M:Neu
ACATCGAAGAAACTGT	M:Neu
AGGACTTTCCTCTCTT	M:Neu
ATTCATCCAGAGGCAT	M:Neu
TGGAACTGTACGACAG	M:Neu
TTCTTCCAGAGAGGGC	M:Neu
TTGTTGTGTACTGCGC	M:Neu
GTACAACAGGATTCCT	M:Neu
AACTTCTTCCCGAGGT	M:Neu
CAACGGCGTAATACCC	M:Neu
CTAGACACATAATCCG	L:B
CTGCATCTCAAGCCGC	M:Neu
TGCATGAGTGCATGAG	M:Neu
AATGGCTAGGCGACAT	M:Neu
ACAGCCGAGTCCCGGT	M:Neu
AATGGCTGTAACACGG	M:Neu
AGGATAAGTGGCCTCA	M:Neu
CACAGATTCGCCACTT	M:Neu
GTAGATCAGTTATGGA	M:Neu
TAGGTTGAGTATGACA	M:Neu
ACATGCATCCGTAGGC	M:Mono:mDC
ACGATGTAGCGCTGCT	M:Mono:mDC
ATTCCCGAGGTGCTGA	M:Neu
CTACGGGGTTCGTTCC	M:pDC
CTCTCGATCAAGTCGT	M:Neu
CAGATCACATAGTCAC	M:Neu
CATACAGGTCAGCTTA	M:Neu
CATGCTCTCGCACTCT	M:Neu
CTGCCTACAATCGCCG	M:Neu
GTCATTTTCCTGGCTT	M:Neu
TACGGTAAGTTAACGA	M:Neu
TCTGCCAGTATGGAAT	M:Neu
ACTATCTAGATTGGGC	M:Neu
CCACGTTGTCACTTCC	M:Neu
GTCAAGTCAGAGTCTT	M:Mono:mDC
GTTGCTCAGTCATCGT	M:Neu
TTTCATGTCGGCTCTT	M:Neu
CAAGAGGCACTCCCTA	M:Neu
CATGCCTGTTCAAACC	M:Neu
CGTAATGAGTCATAGA	M:Neu
CTCCAACGTTAGGAGC	M:Neu
GACGTTAGTGTGAGCA	M:Neu
GATGTTGAGACTAGAT	M:Neu
GCAGTTAGTAGGTAGC	M:Neu
TACCCACCAAGGAGTC	M:Neu
TACCCGTTCCGCGATG	M:Neu
TCACATTAGGCTCTAT	M:Mono:mDC
TCTACCGAGGTTAGTA	M:Neu
TTTCGATAGGTGGTTG	M:Neu
CAGTTAGCATGTTTGG	M:Neu
CGTCCATAGTATAGGT	L:B
CTCAGAAAGGGAGGAC	M:Neu
TGGTTAGTCTTTACAC	M:Neu
CACGTTCAGTATCCTG	M:Neu
CGAAGGAGTATCCCAA	M:Neu
CTAACTTAGGCCTTGC	M:Neu
GCATTAGGTATAGGGC	M:Neu
GTAAGTCGTAACGGTG	M:Neu
TCAAGACTCTACCACC	M:Mono:mDC
AATGAAGGTATGTCAC	M:Mono:mDC
AGAGCAGAGCGAGAAA	M:Neu
AGGACTTTCTATTTCG	M:Neu
CCTCTAGAGGTTCACT	M:Neu
CGAAGGAAGGCGACAT	M:Neu
GGGTCTGCATACAGCT	M:Neu
TCCTAATCACTATGTG	M:Neu
ACGTAACAGAGTTGTA	M:Neu
CGTAATGGTATAATGG	M:Neu
CGTCAAATCGGAACTT	M:Mono:mDC
CTCATTAGTCACTTAG	M:Neu
GACTATGCACATAGCT	M:Neu
TGCGGGTTCAGCCTTC	M:Neu
CAATACGCATGCAGGA	M:Neu
CATACAGGTGTGAGCA	M:Neu
CATCGTCAGAAGCTGC	M:Neu
CCGGACACAGGCACTC	M:Mono:mDC
AATAGAGAGTTGAAAC	M:Neu
GAATAGACAGCCTACG	M:Neu
GAGTTTGTCCTAGAGT	M:Neu
GTGCAGCTCTACCAGA	M:Neu
ATGGATCTCCTACTGC	M:Neu
GGTCACGTCTCTTAAC	M:Neu
GTTCTATAGCAGCCTC	M:Mono:mDC
TCGAAGTCATGGAGAC	M:Neu
TGGCGTGCATAGAGGC	M:Neu
CTCATTATCCTACTGC	M:Neu
GGGACAAGTCCCTGAG	M:Neu
TAGACCACAACGGCTC	M:Mono:mDC
TCAGCAACAATACGCT	M:Neu
AGGCCACGTTGCTCAA	M:Neu
ATTCCTATCGGTGCAC	M:Mono:mDC
CATTCCGGTCTTGAGT	M:Neu
CTCCTTTCATGCGTGC	M:Neu
CTGTATTTCACGGAGA	M:Neu
GATGCTAGTATGGGAC	M:Neu
GGAGATGCACTGTCCT	M:Neu
GGGATCCTCAAGCCGC	M:Neu
GGTCTGGGTAACATGA	M:Neu
TCTTCCTCAATTGTGC	M:Neu
ATTGGGTAGTGCCGAA	M:Neu
AGGGCCTGTTAAGTCC	M:Neu
TCCATGCGTGGTCTAT	M:Neu
CCTCACAAGACTACCT	M:Neu
AGAGAGCCATCTTCGC	M:Mono:mDC
AGTACCAGTATGCGTT	M:Neu
ATTCAGGCATTGAGCT	M:Neu
CGCCATTAGCCAAGTG	M:Mono:mDC
GTTCATTCAAGTGCTT	M:Neu
AATAGAGCATCTAACG	M:Neu
AATAGAGTCAGGCGAA	M:Neu
GAGCTGCTCTTTGCGC	M:Neu
GCGTGCAAGGCTAACG	M:Neu
GTCATCCCAGGTCAGA	M:Neu
TACCCACGTATTAAGG	M:Neu
TACGGTAAGGCGCTTC	M:Neu
GAACGTTGTGTGTGTT	M:Neu
GCCAGCATCTCCCAAC	M:Mono:mDC
GGTAGAGGTGGTCCCA	M:Neu
CCACGTTGTCAAAGAT	M:Neu
GTTAGACAGTGAATAC	M:Neu
TAAGTCGAGGACTGGT	M:Neu
TCATCATTCATGCATG	M:Mono:mDC
ACTTTGTCAAGTATCC	M:Neu
AGTCAACCACACCTTC	M:Neu
GGGATCCCACGGCTAC	M:Neu
TCCTAATTCCTGTACC	M:Neu
AGCATCACAAGAATGT	M:Neu
CCGGGTACAGATTTCG	M:Neu
GCTGAATGTTATAGCC	M:Mono:mDC
GTCCCATCAAGGTCTT	M:Neu
CCACACTTCCCGAGAC	M:Neu
CCATAAGGTTAGGACG	M:Neu
CGAGTGCCATAGAAAC	M:Neu
CTCATGCTCGACACCG	M:Mono:mDC
TGCTCCATCGATAACC	M:Neu
ATGCATGGTTCGGGTC	M:Neu
GGGCCATCAGGTTCCG	M:Neu
TAGCACACAGGTGAGT	M:Mono:mDC
CTACTATGTGTTGACT	M:Neu
GATAGCTCAGTTGTCA	M:Neu
TGGATCAAGCTAATGA	M:Neu
AAGGTAATCCCAGGAC	M:Neu
ACAGGGAAGACGGTTG	M:Mono:mDC
CTCCCAATCGTGGCGT	M:Neu
CAACGGCCACCTCAGG	M:Neu
CAGCAATGTCCTGGTG	M:Neu
TGCGGCAAGGTAACTA	M:Neu
CCGAACGCAACTTCTT	M:Neu
TACACCCTCCGATTAG	M:Neu
TCGGATAGTAGAATAC	M:Neu
TCCTTTCTCGGCTGTG	M:Neu
TGAGGAGGTAAGATCA	M:Neu
TTCCGGTCATCGTGCG	M:Neu
ACTCCCAGTGGTCTGC	M:Neu
CGAAGTTGTTCCACGG	M:Neu
CTGATCCCATGACACT	M:Neu
ATCGCCTCACTACCCT	M:Neu
CTAAGTGAGTCACGCC	M:Neu
GATGATCAGGTTTGAA	M:Neu
GATTGGTTCGCTGACG	M:Mono:mDC
TGTAAGCGTGTCCACG	M:Neu
TTGTGGACACCTTCCA	M:Neu
CACTAAGAGCAGGCAT	M:cDC
CCCAACTAGGGTCACA	M:Mono:mDC
GTGTGGCAGGTCATAA	M:Neu
TCTGGCTGTATCGCAT	M:Mono:mDC
AACCTTTGTGAGCGAT	M:Neu
GGGTTTAGTCAAGCCC	M:Neu
GTTATGGAGTAGCAAT	M:Neu
TCTCAGCTCCTCACCA	M:Neu
CAGATACCAGCCGTCA	M:Neu
CAGCAATTCAAGCCCG	M:Neu
GTAACACAGGTGCTTT	M:Neu
TAATCTCCACAGTACT	M:Mast
AATGAAGCAACCGACC	M:Neu
ACGGTTAGTGTAAACA	M:Neu
GCCATTCGTGGTTTAC	M:Mono:mDC
TACGCTCCATGACAGG	M:Mono:mDC
GCCAGTGAGAAGTCTA	M:Neu
GGGACAAAGCAGGGAG	M:Neu
GTTCTATAGGTCGTGA	M:Neu
TCAATTCGTCGTTTCC	M:Mast
TCAATTCTCGTGTTCC	M:Neu
ACCTGTCAGGAGGTTC	M:Neu
ACTGTCCTCGCAATGT	M:Neu
GGGACTCCATGGGATG	M:Mono:mDC
TCCCAGTTCGACCACG	M:Neu
TGCGGGTTCGTTCCTG	M:Neu
ACGTAGTGTGTGTCCG	M:Neu
AGTCAACTCGACACTA	M:Neu
CTACATTCACTCTGCT	M:Neu
CATCGTCCACTCCTGT	M:Mono:mDC
CGCCAGAGTCCAAGAG	M:Neu
GGCACGTAGGTAGCAC	M:Neu
TCTACATAGACGACGT	M:Neu
ACTCTCGAGTAATTGG	M:Neu
GGCACGTTCCCGTAAA	M:Neu
TAAGTCGCACAAAGCG	M:Neu
TCAGGGCCATCCGCGA	M:Neu
ACACCAAGTAAGGAGA	M:Mono:mDC
TGCTTCGTCTGTCGCT	M:Neu
ATTTACCTCGTCGGGT	M:Neu
TCACACCAGTCTCGTA	M:Neu
AAGCGAGCACAAGTGG	M:Neu
CATTGTTTCTGACGCG	M:Neu
GAAGAATGTAACGCGA	M:Neu
TCTCACGTCTGAATGC	M:Neu
TTCGCTGCAGGCCTGT	M:Neu
CAACAGTTCGGTAGAG	M:Neu
CATTGTTCATATGAAG	M:Neu
CTTAGGATCGCAAGAG	M:Mast
GCCGATGAGGGTCACA	M:Mono:mDC
ACTTTCAAGCAATAAC	M:Neu
AGGTTGTCAGCTATAC	M:Neu
ATCGTAGCATGAGATA	M:Neu
GGTAGAGCAACTGCCG	M:Neu
TCATATCTCTTTGCAT	M:Neu
TGGATCAAGTCGCCCA	M:Neu
AAGATAGGTGTTACAC	M:Neu
ATTATCCCATTGTCGA	M:Mast
CCACCATTCACCCTTG	M:Neu
CTCACTGGTCCCACGA	M:Neu
CTGGCAGGTTTAAGGA	M:Neu
CTTAGGACAGACCAAG	M:Neu
GTTGCTCGTATGACAA	M:Neu
TAGAGTCAGGAAGTCC	M:Neu
TAGGGTTCAGTTTCAG	M:Neu
TATTCCACATATCTGG	M:Neu
TCTGGCTGTTCGTACA	M:Neu
ACAGGGATCTCGGCTT	M:Neu
GACTCTCAGAAGATCT	M:Neu
GGAAGTGGTTTACGAC	M:Neu
TGTTCATAGTAACGTA	M:Neu
ACCATTTTCACGGTCG	M:Mono:mDC
GGGTTTAAGACTCTAC	M:Neu
GTCAAACAGTGGGAAA	M:Neu
GCAACATAGAACAGGA	M:Neu
TGTTCCGTCACGGACC	M:Neu
AGGTGTTAGACTTCAC	M:Neu
CTCTCGAGTCTTGGTA	M:Neu
AGGGTGACATAACCCA	M:Neu
CACTAAGTCAAGAAAC	M:Neu
TCATGCCGTCATCCGG	M:Neu
TCGCTTGGTTAATCGC	M:Mono:mDC
AACCTGAAGAATACAC	M:Mono:mDC
CTGCAGGAGTATCCTG	M:Neu
TACCCACTCAGCTCTC	M:Neu
CTACCTGCATACTTTC	M:Neu
CTCTGGTCATAACGGG	M:Mega
CAGGGCTTCTTCGGAA	M:Neu
GATCACAAGGCACCAA	M:Neu
GCTTTCGGTGTTAGCT	M:Neu
TTACTGTTCATTTCCA	M:Neu
CGGGTCAAGGTACAAT	M:Neu
CTTCCTTGTTTACTTC	M:Mono:mDC
GGAATGGAGATCCTAC	M:Neu
GTTGCTCTCTCTCAAT	M:Neu
TTTCATGGTGAATGAT	M:Neu
ATGTCCCTCTGTGTGA	M:Neu
ATTCGTTGTTATTCTC	M:Neu
CAACCTCGTTGTTTGG	M:Mono:mDC
TGGGTTAAGGAAGTCC	M:Mono:mDC
CCTCACATCGCAGTTA	M:pDC
CGCAGGTGTGTGATGG	M:Neu
CTCAATTCAGCTATTG	M:Neu
TCAGTTTGTAGCTGTT	M:Neu
TGTGCGGAGCTGAAGC	M:Mono:mDC
CTACTATAGGATTTGA	M:Neu
GAAGCGATCAAACGAA	M:Neu
TGACGCGAGGTTAAAC	M:Neu
CTCCACACAGGACGAT	M:Neu
ATCGTGAGTCCTGTCT	M:Neu
CCGTGAGAGTCTGCGC	M:Neu
GCTACCTAGATGGGCT	M:Mono:mDC
GCTGAATGTTAGCGGA	M:Neu
GTTAGACAGTTAACAG	M:Neu
TGGGAGAGTAATGCTC	M:Neu
TTCTAGTAGCAACAGC	M:Neu
AATGAAGAGCCGAATG	M:Mono:mDC
TATCTTGTCGCGCTGA	M:Mono:mDC
AAATGGAGTCTGCCTT	M:Neu
ATGAGTCAGTCTTCCC	M:Neu
CCGGTGATCCGGACGT	M:Neu
CTGCATCCAATTGTGC	M:Mono:mDC
GAACGTTCATCAGCAT	M:Neu
TCACGGGCAGAAATTG	M:Neu
TCCGAAAGTGTGGACA	M:Neu
TTGGGTATCAAAGGAT	M:Neu
ATGGGAGGTAGCTCGC	M:Mono:mDC
CGAGAAGAGTTGCCCG	M:Neu
GACTATGTCCTTCTAA	M:pDC
GAGCCTGTCATTCGTT	M:Neu
TGCATGAGTACGTACT	M:Neu
AGTTCCCCAACGTAAA	M:Neu
CCCAACTAGACATCCT	M:Neu
CGTCAAAGTTTGTTGG	M:Neu
GGGTGAAGTATTGCCA	M:Neu
TTGCATTTCCATTGCC	M:Mono:mDC
AGCGTATGTCGAGCAA	M:Neu
CCAATGAAGGGAGTGG	M:Neu
GTCAAACAGATGGGCT	M:Neu
TTTGACTTCGTAACTG	M:Neu
CTTGATTCAGCCGGTT	M:Neu
GACCGTGCATAACCCA	M:Neu
GGGAAGTAGTTCCGGC	M:Mono:mDC
GTATTTCTCGAACGCC	M:Neu
AGGGTCCTCCACGTCT	M:Mono:mDC
ATTCTTGAGCATTGTC	M:Neu
CAGAGCCAGATACTGA	M:Neu
GCTGCAGAGCTACTAC	M:Neu
AATTTCCAGCGTGAAC	M:Neu
AGGTGTTTCTGGGTCG	M:Mono:mDC
CCCAACTGTAGACTGG	M:Neu
GCCAGGTAGTCTTCCC	M:Neu
ACTTAGGAGTGGTTAA	M:Neu
CCGGGTATCCTACGGG	M:Neu
CCTCAGTTCCTGTAGA	M:Mono:mDC
TACTTCAAGCCTGTGC	M:Neu
CCACACTAGGGAGATA	M:Mono:mDC
TGGTGATGTATTTCTC	M:Mono:mDC
AACGTCATCGGCAGTC	M:Mono:mDC
CCGAACGGTCAAGTTC	M:Neu
CCCTAACAGACTCCGC	M:Neu
GGCAGTCTCGAAGTGG	M:Neu
AGTCAACTCATAGCAC	M:Neu
CACACAACAGACCCGT	M:Neu
GGGAGATAGCAAGTGC	M:Neu
GTTCGCTAGTGCCTCG	M:Mono:mDC
TAGGTACCAACGTTAC	M:Neu
TATACCTCACGTCTCT	M:Neu
TCATGAGAGCGCCTCA	M:Neu
CAGATACCATGCGGTC	M:Neu
TACAGGTAGCAGGCAT	M:Neu
TCTCTGGCAGGTTCCG	M:Mast
ACGTACAAGTTGCCTA	M:Neu
CGATCGGGTTCGGTAT	M:Mono:mDC
GATGAGGCATGGATCT	M:Mono:mDC
TGGTGATTCTCAGTCC	M:Neu
AGTACTGTCACCTCGT	M:Neu
ATCACTTAGTAACCGG	M:Neu
CAGATACAGAGTAACT	M:Neu
CAGGGCTGTCATTGCA	M:Neu
CAGTTCCGTCACTCAA	M:Neu
GTGATGTCAGGTTCCG	M:Neu
TAGGTTGCACCATATG	M:Neu
AATCACGAGGACAACC	M:Neu
CTTTCAACACCAGTAT	M:Neu
GTTAGTGTCGTAGGGA	M:Neu
TCCCAGTTCTTAGCTT	M:Neu
TGTCCCACACTCAAGT	M:Neu
TTAATCCTCGGTAAGG	M:Neu
ATTACCTGTACCCGCA	M:Mono:mDC
CACTGAAGTCAAGCCC	M:Neu
TTCGGTCTCAGGACGA	M:Neu
AACCTTTTCATCCTAT	M:Mono:mDC
ACATTTCCAACGAGGT	M:Neu
GCCAGCAGTTTGGGTT	M:Neu
AGGTTGTCATCAACCA	M:Neu
CACCAAAAGGGAGGCA	M:Neu
CTTAGGAGTTGCTCGG	M:Neu
CTTGAGAGTGAACTAA	M:Neu
GAAGTAACAATCGCGC	M:Neu
GCCAGCAGTGAAGCTG	M:Mono:mDC
TGATCAGTCGGATTAC	M:Neu
CATACTTTCATGAGAA	M:Neu
TCATCCGAGACATCCT	M:Mono:mDC
TTGATGGAGTCCCGGT	M:Neu
CCACGAGCACCAGCCA	M:Neu
AGGTTACTCTGTCCGT	M:Neu
TCTTAGTCAAGTCCCG	M:Neu
TTTATGCAGCTTCTAG	M:Mast
TTACAGGTCTTGGCTC	M:Mono:mDC
TTGGGATGTCCACGCA	M:Neu
AACCCAATCAGCTGTA	M:Mono:mDC
GACCTTCTCCATGCAA	M:Neu
TTACGCCAGCTCGTGC	M:Neu
GTGTGATTCGAGATGG	M:Neu
AACAGGGGTCTGTCCT	M:Neu
GAACGTTAGCAGGCAT	M:Neu
TACAACGTCCAAACCA	M:Neu
AATGACCTCCCGAGAC	M:Neu
CTGCAGGGTGCTCCGA	M:Mono:mDC
TCATTTGTCACCCTCA	M:Neu
TGCACGGAGTTAACGA	M:Neu
GATGCTAAGTTGCTGT	M:Neu
TGAGTCAAGACGCAGT	M:Neu
TGTCCTGGTTCCCACT	M:Mono:mDC
AAGCATCTCAAGTCGT	M:Neu
ACAAAGAAGAGCCGTA	M:Neu
CACGGGTCAAGATGTA	M:Neu
CCATCACCAGGATCTT	M:Neu
CATTGAGAGAGCAGTC	M:Neu
GGACGTCAGTTCGCAT	M:Neu
GGGCCATAGGAGAGGC	M:Mono:mDC
GTCATCCCAAGACGGT	M:Neu
ACCCTTGAGATGTTCC	M:Neu
CCCTCAATCGGTAGAG	M:Neu
TATCTGTGTGGCGTAA	M:Neu
TCCGATCAGTGGTTCT	M:Mono:mDC
TCTGCCAAGGATATGT	M:Neu
AATGACCAGTTGCCCG	M:Neu
CAGCGTGGTATTGCCA	M:Mono:mDC
CATCCCATCCTAGAGT	M:Neu
CTTTCGGAGGAGCTGT	M:Neu
GAGTTGTAGTATGTAG	M:Neu
TAGACCACAGCTTTCC	M:Neu
TCGCTCAGTGGACTGA	M:Neu
TGATTTCTCGGCTTCT	M:Mono:mDC
TGTAGACTCTTGTGCC	M:Neu
AACCACACAATAACCC	M:Neu
AGGTTACCAATTGTGC	M:Neu
GGGACAACAATAACGA	M:Neu
GGGACCTTCTACGCAA	M:Neu
GGTGTCGAGGATGAGA	M:Neu
GTGGAGAAGTCCCGAC	M:Neu
ACGGAAGGTGGCAGAT	M:Neu
GAGCTGCTCGCTATTT	M:Neu
TTACTGTAGCTCCATA	M:Neu
CTATCCGAGCTGCCTG	M:Neu
GATTCGATCAAGTCGT	M:Neu
GGAGATGCAAGCACCC	M:Neu
TATCAGGGTGTTACTG	M:Neu
TGAGGGATCCTCTAGC	M:Neu
ACCCAAAAGCGCAATG	M:Neu
CGTTAGATCTACTTCA	M:Neu
CTTCAATAGGATATGT	M:Neu
TCTGCCATCTCACTCG	M:Neu
TTTGGAGTCACGGTCG	M:Neu
AACCAACTCACCGACG	M:Mono:mDC
AACCTTTCAGGTGGAT	M:Neu
GCAACATCAAATCCCA	M:Mono:mDC
TACACCCGTAACACCT	M:Neu
AGTAGTCGTTTAGACC	M:Mono:mDC
TCTTGCGAGCAAACAT	M:Neu
TATCTTGCAAACTGCT	M:Neu
CAGATACGTTCTGACA	M:Neu
GAGCCTGAGACCACGA	M:Neu
GAGGCCTCAGCATGCC	M:Neu
AATGGAATCGCACGGT	M:Neu
ATGGGTTCACAACCGC	M:Neu
ATTGTTCAGGGTAATT	M:Mono:mDC
TGAGTCACAGTGTATC	M:Neu
ATACCTTGTTCTGAGT	M:Neu
GCCCAGATCTCCGTGT	M:Mono:mDC
ACTGTGATCAATCCGA	M:Neu
CGACAGCCAGCGGTCT	M:Mast
GGGACAATCCGTGACG	M:Neu
TTTGGAGAGCATTTGC	M:Mono:mDC
GCGTTTCCAACTTGCA	M:Neu
GGGTTATTCATTTCCA	M:Neu
TTTACGTCACGGAAGT	M:Neu
CTATCCGTCAACGAGG	M:Mono:mDC
GGGTCTGAGGTGAGCT	M:Neu
TCTGGCTAGCTTACGT	M:Mono:mDC
CAGATACGTTGGCCTG	M:Neu
GGGACCTAGACTGAGC	M:Neu
TGAACGTAGGTCCAGA	M:Neu
AGCATCATCCGCGGAT	M:Neu
AGCCACGGTATCGGTT	M:Mast
GACTTCCAGTTGTAAG	M:Neu
TCAGCCTTCACTTTGT	M:Neu
TCATGTTGTTTCGCTC	M:Mono:mDC
CACATGACACGGTAGA	M:Neu
TCTAACTCATGGCTAT	M:Mast
GAGGGTATCCGATCGG	M:Neu
GAGTTTGGTCTGCAAT	M:Neu
CATGCTCCAGCATACT	M:Neu
AAAGGATGTGAGTAAT	M:Neu
GTGAGCCCAAGGCAAC	M:Neu
AGGTCTAAGAAGTCCG	M:pDC
ATTCTTGAGATTACCC	M:Mono:mDC
GACTCTCCATCAGCAT	M:Neu
GATTCGAGTGGCTTGC	M:Mono:mDC
TCAGCCTAGATGCCGA	M:Neu
TTGAGTGCAGGCCTGT	M:Neu
TTGTTGTAGTCAGCGA	M:Neu
CTACGGGGTCACTAGT	M:Neu
GCCATTCCACAACCGC	M:Neu
GTAGAGGGTGTAGTGG	M:Neu
AATGGAAAGTCGCCCA	M:Neu
CACTGGGTCGTCCATC	M:Neu
GCAGCCAAGTAAACAC	M:Neu
AAGACAAAGTACAGAT	M:Neu
TTTGACTCAGACCTAT	M:Neu
GAAGAATCAAATACAG	M:Neu
GGGTAGAAGATTACCC	M:Mono:mDC
TCGCAGGGTATGATCC	M:Neu
AAGACAAGTTGTGCAT	M:Mono:mDC
GAAGCCCCAAGGCAAC	M:Neu
TCTCACGCAGAACTCT	M:Neu
TCACGGGTCATCAGTG	M:Neu
TGCGGCACAACAACAA	M:Neu
TTGGGTATCTCGAACA	M:Neu
ATGAGTCCAAACCGGA	M:Neu
CTATAGGGTCTACACA	M:Neu
ACACTGATCAGCTGAT	M:Neu
AGGGTCCGTTTGGGAG	M:Mono:mDC
ATTTCTGCAAATCGTC	M:Mono:Mac
GCTACAAGTTTACGTG	M:Neu
TACATTCTCACGGTCG	M:Neu
TCATCCGGTAGTGCGA	M:pDC
TTCACCGGTGCTCTTC	M:Neu
TTCTTGAAGATGACCG	M:Neu
GCTACAACAGCAGGAT	M:Neu
TTCACGCTCGTAGTCA	M:Neu
TTGCCTGAGCGCCCAT	M:Mast
ACATCCCAGCAACAAT	M:Neu
ATGGGAGAGAGCAGTC	M:Neu
CCCTCAATCTTCGTGC	M:Neu
CGAGAAGTCTCCAATT	M:Neu
TGGTACATCAGCAGAG	M:Neu
CATGAGTGTATCTCTT	M:Neu
TATCAGGTCTTGCAAG	M:Mega
TGCCGAGGTCTGATAC	M:Mono:mDC
CGAGTGCCACGTTGGC	M:Neu
GCCAGGTAGATACCAA	M:Neu
GAAGAATCATAGCTGT	M:Mast
AATTTCCCAATTCTTC	M:Neu
ATGCCTCAGAGTCACG	M:Neu
GCCATGGGTCTCACGG	M:Mono:mDC
TCTGGCTTCCCGATCT	M:Neu
AATGGAAAGTGCACCC	M:Neu
AAGAACAAGGTAAGGA	M:Neu
CTCCTCCGTTACCTGA	M:Mono:mDC
TCATGCCTCCACTAGA	M:Mono:mDC
TCCATCGTCGCGGACT	M:Mast
TGCTCCACAGGCTATT	M:Neu
ACCCTTGGTAGTTACC	M:Neu
GACCGTGAGTTGCGCC	M:Mono:mDC
TGCCGAGTCGGTCACG	M:Mono:mDC
ACAACCATCCAGTGCG	M:Neu
CTTTCGGGTGAGCAGT	M:Mono:mDC
AGTAGTCGTGAGGAAA	M:Mono:mDC
GATGGAGCAGAGGACT	M:Neu
GTTAGACCAGTAGAAT	M:Mono:mDC
TCCGAAACAATGTCAC	M:Neu
ATTCATCTCGTTCCCA	M:Neu
CTGCAGGGTTAGAGAT	M:Neu
GGGCTACCAGGAGACT	M:Neu
TCAGTTTCACACCGAC	M:Neu
TTCGGTCGTCACTCTC	M:Neu
ACTTTCAGTGCTGCAC	M:Mono:mDC
GATTCGATCACTTGGA	M:Mono:mDC
TAGGAGGGTTCACCGG	M:Neu
TATCCTAAGTCATGCT	M:Mono:mDC
CATCAAGGTCTCTCAC	M:Mono:mDC
AGAAGTATCCGAGAAG	M:Neu
TTCCTTCGTACTGTTG	M:Neu
CATGGATAGAGGTCAC	M:Neu
GGGTCTGCAAAGGGTC	M:Neu
TCCTTTCGTTTCGTGA	M:Mono:mDC
CTACTATCAATTGGTC	M:Mono:mDC
GACTCAAAGGTCCTGC	M:Neu
GTAGCTACAGACAATA	M:Neu
TGAGTCAAGAATCGAT	M:Mono:mDC
TGGGAGATCTCAACGA	M:Neu
TTACGTTGTCAGACGA	M:Neu
GTAGGTTGTGATACCT	M:Neu
TACCCACTCAGTCACA	M:Neu
TCAGCAAAGCGTGAAC	M:Neu
AAAGAACCAAACTAAG	M:Neu
CTGTATTCAAACTAAG	M:Neu
AGAAGCGAGAGGTTTA	M:Neu
AGGACGAGTTGCATTG	M:Neu
CAACGATGTTCATCTT	M:Neu
CACCAAACAGGGCTTC	M:Neu
CCTCAACCAGCGAGTA	M:Mono:mDC
CGTCAAACAGAGAGGG	M:Neu
TGTGAGTAGGCGCTCT	M:Neu
ATACCGATCGCATGAT	M:Neu
AAGCGAGTCTCGTGAA	M:Neu
CGTAGTACATGGTACT	M:Neu
AGCCACGTCGTTGTTT	M:Mast
TGGAACTCAGCGATTT	M:Mono:mDC
CACGTTCGTATTGGCT	M:Neu
CATCCACCACTGAATC	M:Neu
CATGCAAGTGCCCGTA	M:Neu
CTAGGTAGTGTTACAC	M:Neu
GATCGTACACGAGAAC	M:Neu
GCAACATTCCTAACAG	M:Neu
ATCCTATCAGCAGACA	M:Neu
AGGGAGTTCATCCTAT	M:Neu
AGTTCCCAGACATATG	M:Neu
GGATCTAGTCCGGTCA	M:Neu
CTAGGTACAAGTTGGG	M:Mono:mDC
GGATGTTTCCGCTAGG	M:Mono:mDC
GTGGTTATCAGAGCAG	M:Mono:mDC
TACATTCGTCGTAATC	M:Neu
AAGACTCTCAAGATAG	M:Neu
CCATCACCAACCAACT	M:Mono:mDC
AACCACATCCTCTAAT	M:Neu
AGTAGTCCATGGATCT	M:Mono:mDC
GATCAGTTCTTCGTGC	M:Neu
AGCCACGAGTGAGTTA	M:Neu
TCTGTCGGTTCGTAAC	M:Neu
AGAAGTACACTGAGTT	M:Neu
AGAGAATGTTGGACTT	M:Neu
CAAAGAACACTAACGT	M:Neu
CAGAGCCCAGTGTATC	M:Neu
CAGCAATCACTCACTC	M:Neu
GGGTCTGTCTAGCCAA	M:Neu
CATAGACAGGTGCCTC	M:Mono:mDC
GGTGGCTCAGCTGCCA	M:Mono:mDC
TCCATCGCATACAGGG	M:Neu
CCTACGTAGGCCCACT	M:Mono:mDC
AACAACCCAACACAGG	M:Mono:mDC
ACGATCATCTTTGCAT	M:Neu
ATCGCCTCAACAACAA	M:Neu
CAGGGCTAGTGATAGT	M:Neu
TTACCGCGTGGCATCC	M:Neu
ACCCTTGTCCGACATA	M:Neu
ACGTAGTTCGATTCCC	M:Neu
GAGGGTAGTGTCTTAG	M:Mono:mDC
CATCGCTCAAGAGCTG	M:Neu
AAGTGAAAGTTTGAGA	M:Mast
CCAAGCGGTATTGACC	M:Neu
TAGACTGAGTGAGGCT	M:Neu
CAGCAATAGTTCCGGC	M:Mono:mDC
GGAGATGGTTGCGGCT	M:Neu
CTGCCATAGGACGCAT	M:Neu
TTGAGTGTCACCGACG	M:Neu
CCGTTCAAGGATTCCT	M:Mono:mDC
TATGTTCTCTACCTTA	M:Neu
CACACAACATTGCAAC	M:Neu
CATGCCTCAATTGCTG	M:pDC
AGGAAATCAGGTGGAT	M:Neu
CGGGTGTGTCTGTAAC	M:Neu
GCGTTTCAGGGAACAA	M:Mono:mDC
TGACTCCAGGTGCCAA	M:Neu
CCGGTGATCTAGTACG	M:Neu
TATCTTGTCCGTGTCT	M:Mast
AGTAACCAGCGCACAA	M:Neu
ATCGTCCAGTTGGGAC	M:Neu
GTATTGGAGTAGTCCT	M:Neu
ATGCATGCATGACACT	M:Mono:mDC
TTCTGTAGTTGGGTTT	M:Neu
AAAGGTATCCGGACTG	M:Neu
CACGTTCTCGTGCAGC	M:Mono:mDC
TAACTTCAGAGGGCGA	M:Neu
TGGGAAGTCAAGGTGG	M:Mono:mDC
TTGGGCGCATACCACA	M:Neu
AACCTGATCCTGTAAG	M:Neu
GCAGGCTTCCGGCAGT	M:Neu
GTCTAGAAGCTGGCCT	M:Mono:mDC
AGCCACGAGCACGGAT	M:Neu
CCCGAAGAGACACACG	M:Neu
CCGAACGAGAAGCTGC	M:Neu
CGAATTGCATAACGGG	M:Neu
GGGACCTAGCATGAAT	M:Neu
CCTGTTGCACCCTAGG	M:Neu
GATTCGACACAGACGA	M:Neu
AACAACCAGCCTCATA	M:Neu
ACACCAATCCAAGGGA	M:Mono:mDC
GTTGCGGTCCATCCGT	M:Neu
GTGCAGCAGCCTGGAA	M:Neu
TCGCTTGTCATAGACC	M:Neu
TGCGGGTGTTCAGCGC	M:Neu
ACACCAACAATACGCT	M:Neu
CTCCGATGTGAATATG	M:Neu
GATAGAAAGTGTACCT	M:Mono:mDC
AGCCACGGTGAGAACC	M:Neu
AGGCCACTCGGTCTAA	M:Neu
TGCTCCAAGAGAGTGA	M:Mono:mDC
GGGTCACCAACACGAG	M:Neu
GTGCTTCCACACAGAG	M:Mono:mDC
TCATGTTGTTATAGAG	M:Neu
GGGTGAAGTGTTACAC	M:Mono:mDC
GGTGTCGCAGGAATAT	M:Neu
TAATTCCCACAAGTGG	M:Mega
TATACCTCAAGCCATT	M:Mono:mDC
CACCGTTCAGCAGATG	M:Neu
CTGCCTAAGAAACTAC	M:Neu
GGCTGTGGTCGGTACC	M:Neu
GGGTAGAAGCGACATG	M:Neu
TATCGCCCAGCGCTTG	M:Neu
CGTTAGATCTGATTCT	M:Neu
AGACAAACAGCCTACG	M:Neu
CAGCCAGTCTTGAACG	M:Neu
GTATTGGTCCTAAGTG	M:Neu
TCCTCGACACTCATAG	M:Neu
AAATGGACATCCTCAC	M:Neu
AAATGGATCTTGCAAG	M:Neu
TGCAGATTCACTACGA	M:Neu
ACCCTCAAGTCATGAA	M:Neu
AGAACAAAGGCACGAT	M:pDC
ATCCATTCAGTCTGGC	M:Neu
CGGGTCAGTATGCGTT	M:Neu
TGATGCATCCCGAATA	M:Mono:mDC
TGGGCTGTCACTCACC	M:Neu
TTTACCAGTCGAGTTT	M:Mono:mDC
CAACGGCCATGTGCCG	M:Mono:mDC
CCGCAAGCAGTTTCGA	M:Mono:mDC
GAATAGAAGATAGTCA	M:Neu
GATAGCTAGTGCGACA	M:Neu
GGTGTCGGTGTCATCA	M:Mono:mDC
CATAAGCCACACACTA	M:Neu
GGTGAAGTCGTTCTCG	M:Mast
AAGCCATCATAAGATG	M:Neu
CGATGGCGTGACCTGC	M:Mono:mDC
GTTAGTGTCATCAGTG	M:Neu
TGCGACGGTGGAAGTC	M:Neu
CATGCAACAAACACCT	M:Neu
GCTTTCGCAGCTGGTC	M:Mono:mDC
AGGTTACTCACAAGAA	M:Neu
TTACCGCAGTGAATAC	M:Neu
TTTCAGTCAACACACT	M:Mono:mDC
AGCTACATCTCTCCGA	M:Neu
GGGAAGTCAATAACCC	M:Neu
CCAATGATCCTGGTCT	M:Mono:mDC
TCCGGGAAGGAGTCTG	M:Neu
TCTCCGAAGAGGCGGA	M:Neu
GGGTTTAAGTGCAGCA	M:Neu
CACGAATTCCACTGGG	M:Neu
CCTCAGTCAAAGGGTC	M:Mono:mDC
CGTTAGATCCTTCTTC	M:Neu
GTTATGGAGCCACAAG	M:Mono:mDC
TAGACCACATCCGATA	M:Neu
AGACTCACATCCGAGC	M:Neu
AGTACCAAGGTTCTAC	M:Neu
CTCCTTTCACTCTCGT	M:Neu
TGTGAGTAGTGGCGAT	M:Neu
ATGCCTCAGACCAGAC	M:Neu
GATTTCTGTCTACAGT	M:Neu
GTTCATTTCCGTAATG	M:Neu
AACGTCAGTACCCGAC	M:Mono:mDC
ACTTAGGCACGCAGTC	M:Neu
CGTCAAAAGTCCGCCA	M:Neu
CTGCCATGTTGGGTAG	M:Neu
GATAGAAAGAACGTGC	M:Mono:mDC
TTACGTTCATAAGATG	M:Neu
ACGTAACAGATTCGCT	M:Neu
TGTGATGGTCGAACAG	M:Neu
ACATCGAGTCTTCGAA	M:Mast
GATCCCTCAGTGTGCC	M:Neu
TTCCTAACATGGGATG	M:Neu
AATCACGTCTCTGCCA	M:Neu
CAGGCCATCCGCGATG	M:Neu
CTCCCTCAGAAGTATC	M:Neu
AGGGCCTCACACGCCA	M:Neu
TCTTAGTCAAGCGGAT	M:Mast
ACCACAAGTAATTAGG	M:Neu
CATGCAACAGCTTTCC	M:Neu
GTTGTAGTCTTACCAT	M:Mono:mDC
AGTTAGCTCCCTATTA	M:Neu
GTGATGTCAAATCGTC	M:Neu
TTCACCGCATCCGTGG	M:Mono:mDC
GTGCTGGGTCTGCCTT	M:Neu
TGGGCGTCACCAGTAT	M:Neu
AGTACTGAGACGACTG	M:Neu
CTATAGGCATACGCAT	M:Neu
GTCATTTTCTACCAGA	M:Neu
AAGACTCTCTACCACC	M:Neu
ATGATCGCACGGTGAA	M:Mast
ATCACGAAGTCTAACC	M:Mono:mDC
CTTCAATAGTACGAGC	M:Mono:mDC
GTGGAAGTCCAGTGCG	M:Mono:mDC
CTACCCATCATGCGGC	M:Mono:mDC
GGGAGATTCTTAAGGC	M:Neu
AAGACTCCAATTCTTC	M:Neu
CTATAGGAGGGTATAT	M:Mono:mDC
GACCAATTCTCGGCTT	M:pDC
AAAGTCCGTCCTGTCT	M:Neu
ACTGCAACAGCTATAC	M:Mast
AGAACAATCCGTAATG	M:Mast
CAGATTGCACAATGCT	M:Mono:mDC
CTGGACGCATCGAGCC	M:Neu
CTCAGAACATCCGTGG	M:Neu
GATGATCGTAAGGAGA	M:Mono:mDC
TGACTCCTCTCCGAGG	M:Neu
AAACGAAGTGCAAGAC	M:Neu
AGAACAACAAGGCGTA	M:Mono:mDC
TTCTTGATCCCAGCGA	M:Mast
GCATCTCTCGAATCCA	M:Neu
AGATCCAGTGAACTAA	M:Neu
CGATGCGAGAAATTGC	M:Neu
GACCTTCAGCAAGCCA	M:Neu
CCGATGGAGTGTTGAA	M:Neu
CGGGTGTTCCGCTGTT	M:Neu
GAGGCCTGTATCTCTT	M:Neu
GATCAGTCACCTGATA	M:Neu
CCTCTCCAGTATGAAC	M:Neu
ACCAAACTCATTCGTT	M:Neu
GTACAACAGTAAGCAT	M:Mono:mDC
TGAGCGCTCAAGAGGC	M:Neu
AGTCACATCGTAACAC	M:Neu
GACGCTGCATGCCGAC	M:Mono:mDC
GTGGGAATCGAGAAAT	M:Neu
AAAGTCCGTATCGTAC	M:Mono:mDC
AAGTTCGTCACCTCAC	M:Mono:mDC
TTTGTTGCACATGTTG	M:Neu
TGGGATTAGCAGCCCT	M:Mono:mDC
AGGCATTAGGTTGTTC	M:Neu
CGGGACTTCGCTAATG	M:Neu
TCGGTCTTCCGGACTG	M:Neu
CCTAACCTCGCTATTT	M:Neu
TCCTCGAGTCGAATGG	M:Neu
CGGAGAAGTACACTCA	M:Neu
ATCGGATTCTGGCCGA	M:Neu
ACCTGTCAGGTAAGTT	M:Mono:mDC
AGCGCTGAGTCACTGT	M:Neu
CGATCGGAGGTAGACC	M:Neu
GATCACATCGCAATTG	M:Neu
AATCGACTCACAAGAA	M:Neu
AATGGAAGTAGGAAAG	M:Neu
GGGCCATAGTCGGGAT	M:Mono:mDC
TCTACCGAGTGCCCGT	M:Neu
TTTCACACAACGTATC	M:Mast
GTAACACTCTAGAACC	M:Neu
GTCAGCGCAGCATACT	M:Neu
TATATCCAGTCGCCAC	M:Mono:mDC
ATGGGAGGTCCAGAAG	M:Neu
TGTACAGCAGTGGCTC	M:Neu
ATACTTCAGTACCGGA	M:Neu
TGCAGATAGCAATAGT	M:Neu
TGTGCGGAGATACAGT	M:Mast
TTTCGATGTCATCTAG	M:Mono:mDC
AAGGAATGTTCATCTT	M:Mono:mDC
GGGTTATTCGTTCCCA	M:Mono:mDC
GGGTCTGTCAGTAGGG	M:Neu
CATTGTTAGCGATCGA	M:Neu
CAGGGCTTCGAAATCC	M:Mono:mDC
GTTGTAGCACCTATCC	M:Neu
ACTTCGCGTGCAAGAC	M:Neu
CCTCAACAGTCACGAG	M:Neu
GATAGAATCGATCCCT	M:Neu
GCGGAAACATCTGTTT	M:Neu
TACTTCAAGCTACTGT	M:Neu
ACAGCCGAGCTGAGTG	M:Neu
CATACCCAGGGCCAAT	M:Neu
CTTTCAATCCAATGCA	M:Mono:mDC
CCCAACTAGCAGGGAG	M:Mast
GTGTCCTTCCTAACAG	M:Neu
TAATTCCAGTGGATTA	M:Neu
TGAGACTGTGCAGTGA	M:Neu
ATTCATCCACGACGAA	M:Neu
TATCTGTTCTCATGGA	M:Neu
CTTAGGAAGTTTGGCT	M:Neu
TTCAGGATCAATCCGA	M:Neu
AAAGAACTCACACGAT	M:Neu
TGTGATGCATCGGTTA	M:Neu
GACGTTAGTCAGGTGA	M:Mono:mDC
CATTCATTCAGACCCG	M:Neu
AACCAACAGGCTAACG	M:Neu
ACATGCAAGCTAAATG	M:Mono:mDC
TTCACCGAGTTGCATC	M:Neu
CCGTAGGGTTCCGCAG	M:Mono:mDC
ATGCGATAGCAGATAT	M:Neu
GCTCAAAAGTTTCGAC	M:Neu
CAATCGATCCGCTGTT	M:Neu
TCCTTCTAGAGAGGTA	M:Neu
GATGTTGAGGGACTGT	M:Neu
GCACGTGAGCGCTTCG	M:Neu
CATAGACAGCCTTGAT	M:Neu
CCAATTTCAGAGCCCT	M:Neu
AAGCCATCACCTGTCT	M:Neu
ATGCATGCATCGATGT	M:Neu
TCCTTTCAGGTTCCAT	M:Neu
CATCCACAGTATAACG	M:Neu
CTCTCGATCTATTGTC	M:Neu
GATCCCTCACGTGTGC	M:Neu
ACCTGTCGTTAGGACG	M:Neu
GTAGGTTGTCATGGCC	M:Mono:mDC
CATTTCATCGTCTACC	M:pDC
AAGTACCGTGGGCTCT	M:Neu
GTGTGGCCACACACTA	M:Mono:mDC
TCCGTGTTCGAGCCTG	M:Mono:mDC
CCCTAACTCACTACTT	M:Mast
AACACACTCGTGTGGC	M:Mono:mDC
TCTGCCATCAAACTGC	M:Mast
TTCTCTCCAGTTCCAA	M:Neu
TATCTGTCACTGTGAT	M:Neu
ACCTGAAAGATGAAGG	M:Neu
CGGGTCATCGCTGTTC	M:Mast
GTGCGTGTCTTCGATT	M:Neu
GACATCATCAGCGGAA	M:Neu
AGGTCATTCTACGGGC	M:Mono:mDC
GTCTAGATCTCTGACC	M:Neu
TGGTAGTCACAGCCAC	M:Neu
CATTCCGGTACGATCT	M:Neu
TACACCCGTCCGATCG	M:Neu
GATGCTAAGCACACCC	M:Mast
TTCCGTGGTAAGTAGT	M:Neu
TTGTTGTAGGTCACTT	M:Neu
CCGGGTAAGACGGTCA	M:Neu
TGTCCTGAGTTGTCGT	M:Mono:mDC
ACCAACACATTACTCT	M:Neu
AGCCAGCCACATACTG	M:Neu
CCTAAGACACTCCGAG	M:Neu
GATAGCTCATGATAGA	M:Mast
TGTAACGCAAGCTGCC	M:Neu
CTGTACCCAGGAATCG	M:Neu
GCACTAATCGCCAGAC	M:Mono:mDC
CCTCCAAAGGTGGGTT	M:Neu
TCGAAGTAGACCCTTA	M:Neu
TTCTAGTAGGAAGAAC	M:Neu
GCGGAAACATTATGCG	M:Mono:mDC
CGAGAAGTCGCTTTAT	M:Neu
GCCAGCAGTCACTAGT	M:Neu
GGGTGTCAGGTACAAT	M:Neu
TGGGCTGTCTCACGAA	M:Neu
CGGGACTTCGGAGTAG	M:Neu
CACGTGGGTTGGGTTT	M:Mast
CTTGAGAAGATGGCGT	M:pDC
TTACCGCAGACCTTTG	M:Neu
ATCGATGGTGTGTGGA	M:Neu
AGTCTCCCAGGATGAC	M:Neu
CTATCCGGTCTGATCA	M:Mono:Mac
CTGCGAGCACTGGACC	M:Mono:mDC
TCTGCCAGTCTGTAAC	M:Neu
AATTTCCAGCAGCAGT	M:Mast
ACGTAGTCAAGTCCAT	M:pDC
AAGTGAAGTATCTCTT	M:Mono:mDC
AATCACGAGCTCGACC	M:Mono:mDC
AGACACTTCCCGGTAG	M:Neu
CGTCCATTCAGCAGAG	M:Neu
ATGACCAAGATTCGAA	M:Neu
ATGGGTTGTGGCTTGC	M:Mast
ATTTCTGAGAACGTGC	M:Neu
CCTGCATGTCACCACG	M:Neu
AAGCGAGGTGTGCCTG	M:Neu
ATCATTCAGGTTGGAC	M:Neu
CACCGTTCAGCAGTGA	M:Mast
TTCACGCCAATCAAGA	M:Neu
ATCATTCCAAGGATGC	M:Mono:mDC
TTACTGTAGTAAACGT	M:Mono:mDC
TAGGGTTGTAAGTTAG	M:Neu
AGGATCTTCACGTAGT	M:Mast
GAAGCCCGTACAATAG	M:Neu
TCATCCGCAGCGACAA	M:Neu
GGTAATCAGCATGTTC	M:Neu
TGTTCTAAGCTAAACA	M:Mono:mDC
CTCATCGGTGGATACG	M:Neu
GCCATGGGTTACTCAG	M:Neu
GTTACAGAGTTGAAAC	M:Mono:mDC
TGTCCCAAGCAGCGAT	M:Neu
GCAACCGCAGTATACC	M:Neu
ATTCGTTTCAGTCATG	M:Neu
GATTTCTTCGTAACCA	M:Neu
TACCGAATCTCAGTCC	M:Neu
CCACGAGTCATACGAC	M:pDC
AGGGTCCAGAGCATAT	M:Neu
GAAGCGAAGTTGTCGT	M:Mono:mDC
TCACTCGCACTCAGAT	M:pDC
AGAAATGAGTAGTCCT	M:Neu
CACTTCGGTTGCCAAT	M:Neu
GAGAAATTCATGGATC	M:Mono:mDC
GTAGGAGAGTGTACAA	M:Neu
TTCCAATAGTTCGGTT	M:Mono:mDC
CCTGCATCACGTCGGT	M:Mono:mDC
GTGCACGAGGACCCAA	M:Neu
GGGCTACTCCAGCAAT	M:Neu
AGAAGCGCAACTGGTT	M:Mono:mDC
GGATCTATCATTCACT	M:Neu
CATTTCAGTTCGAACT	M:Neu
TCACGCTTCTGAGAGG	M:Neu
ATGCCTCCAGGACTAG	M:Mono:mDC
CCAATTTGTCGAAACG	M:Neu
GTGAGGAAGGGTCACA	M:Neu
GATGAGGTCAAGGAGC	M:Neu
CTCATGCTCGGTAACT	M:Neu
GTTGTGAGTCGAAGCA	M:Mast
AGTTCCCAGCAACTTC	M:Neu
ATTCCCGTCCGATAGT	M:Neu
GTCTCACCAGCGTGCT	M:Neu
ATCACAGTCCCTCAAC	M:Neu
AGGTCTAGTATGTCCA	M:Neu
ACACTGAGTGGTCCCA	M:Mono:mDC
GAATCACCACTGGATT	M:Neu
ACCGTTCAGCGTGAAC	M:Mast
GGAGGTACACACCTAA	M:Mono:mDC
TTCTGTAAGACGCATG	M:Neu
CATTTCAGTACCGGAA	M:Neu
GTCATCCTCATGACAC	M:Neu
TGCTTGCAGAGGGTGG	M:Neu
TGGTAGTAGGGCGAAG	M:Mono:mDC
CTTGATTGTATCGGTT	M:Mono:mDC
GTCTACCAGGCTCACC	M:Neu
GAGCCTGCACCCTGAG	M:Mast
GGAAGTGCAATACGCT	M:Neu
AGGAAATTCTCTCGAC	M:Neu
TGCTGAAGTCTACTGA	M:Neu
CACGTTCCAAACTGCT	M:Mono:mDC
TGACAGTTCCACCTGT	M:Neu
TGACGCGCAACTGTGT	M:Mast
GTTTACTAGAGTTGTA	M:Mast
GACTGATAGTCCCGGT	M:Neu
TCACACCGTAACGTTC	M:Neu
ACTATTCGTCACCACG	M:Mono:mDC
GTAGCTATCTCATTAC	M:Neu
GCATCTCGTTACGGAG	M:Neu
ACAGCCGCAGGCGAAT	M:Mono:mDC
TACGGTAAGCAATAGT	M:Neu
ATCGATGCACAGGATG	M:Neu
GTTAGTGTCACCGGTG	M:Neu
CATGCAACAAGCTGCC	M:Neu
GACGTTAAGCTATCCA	M:Mono:mDC
ACTTTCAGTCAACCTA	M:Neu
TCAAGTGGTGGAAGTC	M:Neu
AAAGAACAGAAGTCAT	M:Neu
TTTGGAGAGGAACTAT	M:Mono:mDC
CGAGAAGTCAGCGGAA	M:Neu
AGGTTACCAGGCATTT	M:Mono:mDC
TGACGCGCATGATGCT	M:Neu
GTAGAAAAGACTGTTC	M:Neu
CCGATGGTCTGCGAGC	M:Neu
CAGGGCTCAGACAAGC	M:Neu
AGATAGATCGCGTAGC	M:Neu
TCTCTGGCAGCTGCCA	M:Mono:mDC
TCATTACGTTACCCAA	M:Neu
GCAACATAGATTTGCC	M:Neu
TAACTTCCAACACAAA	M:Mono:mDC
TTCCTCTAGAAGTGTT	M:Neu
TTCACCGAGGACAACC	M:Neu
TTTGATCGTTGCTGAT	M:Neu
GTGTTAGAGAAAGTCT	M:Mono:mDC
ATACTTCAGCTGTACT	M:Neu
AAATGGAAGCACAAAT	M:Neu
ATGTCCCTCAATCCAG	M:Mono:mDC
CTGCCTACACGCGTGT	M:Mono:mDC
CATGGATCAGTTAGAA	M:Mono:mDC
AGCCAATCATAGATCC	M:Neu
GTCATTTAGACTAAGT	M:Mono:mDC
GTAATCGCATATACCG	M:Mono:mDC
TGATGCAAGGTCCTGC	M:Mono:mDC
TCCACCAGTATTGAGA	M:Neu
GAAGTAATCACAGAGG	M:Neu
CTGTGAATCCGTGTCT	M:Neu
CATTTCAAGTGCCAGA	M:Mast
CAGAGCCAGGGCATGT	M:Neu
GAGGCAACAGCTCATA	M:Neu
GTCTTTACAGAAGTGC	M:Neu
ACCTACCTCCCATAGA	M:Neu
GGTAGAGTCGGAGATG	M:Neu
ACTACGAAGGAGTCTG	M:Mast
AGCTACAAGAGTAACT	M:Mono:mDC
ATTCTTGAGGAAGAAC	M:Neu
GCCCAGAAGATTCGAA	M:Neu
TCTCACGAGTTGGCGA	M:Neu
ACCTGTCAGAGGATGA	M:Neu
ATGAGTCAGTTCGGTT	M:Mast
AAAGGATGTTCGGACC	M:Mono:mDC
GGGACTCCATAGATGA	M:Neu
CATTGCCCATAGCTGT	M:Neu
TGGATGTTCCATAGGT	M:Neu
AACCTGATCAAGGACG	M:Neu
AAGAACAGTGATACAA	M:Mono:mDC
ATCGCCTGTTATAGCC	M:Mono:mDC
AAGTACCGTTAAGAAC	M:Neu
GGTAATCCACCCAACG	M:Neu
AGAAGCGAGTTGCCCG	M:Neu
CAAGACTAGTTGTAGA	M:Neu
GAACTGTGTACAAGTA	M:Neu
CGAGGAAGTACGTAGG	M:Mono:mDC
TGGCGTGAGCGTGAGT	M:Mono:mDC
TATCTTGTCGAATGCT	M:Neu
TTTGTTGTCGTTCTGC	M:Mono:mDC
ATGCATGTCGGTAGAG	M:Mono:mDC
CTCCGATGTGGTCTGC	M:Mono:mDC
AGGTGTTAGGGTACAC	M:Mono:mDC
CCACGTTTCTGGTGCG	M:Mono:mDC
CCACTTGGTGCTGATT	M:Mast
TTAGGGTAGCCTCTTC	M:Neu
TGCTCCAAGGTTTACC	M:Mono:Mac
GCAACATTCATGGTAC	M:Mast
GAACGTTTCAGTCTTT	M:Neu
GATCACAAGCGACAGT	M:Mast
GCCGATGTCACGATAC	M:Mono:mDC
CTAACTTAGGGATCAC	M:Neu
GAAGTAAGTGAAGCTG	M:Neu
GGGCGTTCATTGAAAG	M:Neu
AAGACAACAGCTGTCG	M:Neu
CTCTCGAAGTCCCAAT	M:Neu
AATGAAGTCGGAAGGT	M:Neu
CTATCTAAGGATACCG	M:Mast
CGAATTGCACAGCTTA	M:Neu
TGATCTTGTTGCTCCT	M:Neu
CAACAGTGTTGGAGGT	M:Neu
CTTTCGGCAGAACCGA	M:Neu
GAAGGGTGTACCGGCT	M:Mono:mDC
TTGTTGTAGCGCACAA	M:Neu
TAAGCACAGGTTCATC	M:Neu
GACGTTATCTCATAGG	M:Neu
TGTTCCGAGAATCGAT	M:Neu
GTAGAGGGTAGATGTA	M:Neu
TTCCAATAGAGGGTGG	M:pDC
TCCTCTTAGTTGCTGT	M:Neu
TTTGACTGTCTCAAGT	M:Neu
CCATAAGCACAGCGCT	M:Mono:mDC
GCACGTGCACTGGACC	M:Mono:mDC
CACGGGTTCTATTGTC	M:Neu
GCATGATAGAATTCAG	M:Neu
GTGGTTAAGCGCCTAC	M:Neu
GTGCTGGCAGCTAACT	M:Neu
CTTTCGGAGATGGGCT	M:Mono:mDC
GGGACTCTCCACGTGG	M:Neu
TACGCTCTCCAGCCTT	M:Neu
GGCTTGGGTTGCTCAA	M:Neu
ACTTATCGTTAGTCGT	M:Mono:mDC
GACGTTAAGCAAATGT	M:Neu
GCCGATGTCCGAGGCT	M:Neu
CTAACTTCAACTGGTT	M:Mono:mDC
GAACTGTTCTACCTTA	M:Neu
TGTGGCGAGCGTATAA	M:Neu
TACGGGCAGCCATGCC	M:Neu
CAGGTATTCGTTCCTG	M:Mast
AAGCGTTCATAGACTC	M:Mono:mDC
CCGATCTGTCGTTGGC	M:Neu
GTGTAACAGCCACAAG	M:Neu
TCTTAGTGTTCGTACA	M:Neu
GTCACTCGTCACCGAC	M:Neu
CCTGTTGGTTTGACAC	M:Neu
GGGTAGAGTCCGTTTC	M:Neu
TGGGAAGCATCATCCC	M:Neu
AATCACGGTGCGCTCA	M:Neu
CGAGAAGAGAATCGTA	M:Mast
AGGATAAGTGTTACTG	M:Mono:mDC
CATCGGGAGGAAAGGT	M:Neu
GTTCATTAGCATATGA	M:Mono:mDC
TGATTCTAGTCTAGCT	M:Neu
CCCTCAACAAAGCACG	M:Neu
TGGGTTATCTGCCTCA	M:Mono:mDC
TCCTTTCCAGCGTTGC	M:Neu
AGTGTTGTCGAGGCAA	M:Mono:mDC
TGGTAGTTCAGTGTTG	M:Mast
GCAACATAGTCAATCC	M:Mono:mDC
CTTTCAACAGTATTCG	M:Mono:mDC
GGGTCTGCAAGGTCAG	M:Neu
ACTCTCGCAATTGAAG	M:Mono:mDC
CGAAGTTAGGTTGGAC	M:Mono:mDC
AGACACTAGTAACAGT	M:Neu
TACGTCCGTGATAGTA	M:Neu
TCAAGACCAGCACCCA	M:Neu
TCACACCTCACATCAG	M:Neu
CTCTGGTTCCTGTACC	M:Neu
CAACCTCAGTCGCCCA	M:Neu
GGGTGTCGTAGGTTTC	M:Neu
GAAGCGATCCACGGGT	M:Neu
AAGCCATCATACCAGT	M:Neu
TTTCGATAGCACGGAT	M:Neu
GGTAGAGTCACAAGGG	M:Neu
CCCTGATAGGTAAGTT	M:Neu
GAAGGGTGTCTACGTA	M:Neu
TTGTTTGAGATGCAGC	M:Neu
GAGGCCTCATTCGGGC	M:Neu
GATGATCAGTTCCGTA	M:Mast
TGTAAGCCACTGCATA	M:Neu
TCTATCATCACACGAT	M:Mast
TATTGCTCACACACGC	M:Neu
ATAGACCCATGACAGG	M:Mono:mDC
CTGTACCTCCGGGACT	M:Mono:mDC
AGATCCAAGTTTCGAC	M:Neu
TCATTACTCGGCTTGG	M:Mast
TGAATCGAGCCTCTGG	M:Neu
TGGATGTTCTCTCTAA	M:Neu
AACCAACGTATGCGGA	M:Neu
AGAACAAAGTAAACAC	M:Mono:mDC
CACAGATTCGTAGCCG	M:Mast
AGAACAAGTTAAGAAC	M:Mast
AAGCGTTAGGATCACG	M:Mono:mDC
ACTGCAAGTAGCTTGT	M:Mono:mDC
ACCCAAATCTCATGCC	M:Mast
AAACGCTTCCGTGACG	M:Mono:mDC
CTCATCGAGTATGGAT	M:Mast
ATTCGTTGTTATGTGC	M:Mast
AATGAAGCAAGTGTCT	M:Neu
ATGCATGTCCACTGGG	M:Mono:mDC
GCACTAAAGACGGTCA	M:Mono:mDC
GATTTCTGTTCTCTCG	M:Mono:mDC
CTCCCAATCACCATAG	M:Neu
CCACCATAGTATTGCC	M:Neu
TGGTTAGAGCCTTGAT	M:Mono:mDC
ATCTTCAAGCACTGGA	M:Neu
TTGGATGAGTGTTGTC	M:Neu
GTTGCTCAGAGAGTTT	M:pDC
CTCCACAAGGACGCAT	M:Neu
AGGAGGTGTCGTGGAA	M:Neu
TGCAGTAGTTGTTGTG	M:Neu
GCAGCCATCAGACAAA	M:Neu
TACTGCCAGACCTCAT	M:Neu
ATTCCATCACGCGGTT	M:Neu
CGGTCAGTCGCAGTTA	M:Neu
ACTTTGTAGGTAGTAT	M:Neu
TGTTGGACAAAGAGTT	M:Neu
GAGTGTTCAACAAGAT	M:pDC
CAAGAGGCAGCGAACA	M:Mono:mDC
CGAGGCTTCCAATGCA	M:Neu
TGTAACGCATGGAATA	M:Neu
TACTTACCAGCTGTTA	M:Neu
GATGTTGCAACCCGCA	M:Neu
AGACCATGTTAGGACG	M:Neu
ACTCTCGTCACCGGTG	M:Neu
GCACGGTCAGGAATCG	M:Neu
TGAATGCGTTAAGGGC	M:Neu
GCCAACGAGTAAACTG	M:Neu
AAGTGAATCGATTCCC	M:Neu
CTGAATGTCCCTCTAG	M:Neu
TTCATGTCACAGTGTT	M:Neu
